border_size=1
usage=map

Wwr         , Wo          , Wo          , Wo          , Wo          , Wo          , Wo          , Wo          , Wo          , Wo          , Wo          , Wo          , Wo          , Ww          , Ww          , Ww          , Ww          , Dd          , Gs          , Gs          , Hd          , Hd          , Md          , Md          , Md          , Md          , Md          , Md          , Md          , Md          , Md          , Md          , Hd          , Hd          , Gs          , Gs          , Gs^Ftd      , Dd^Ftd      , Dd          , Dd          , Dd          , Dd          
Ww          , Wo          , Wo          , Wo          , Wo          , Wo          , Wo          , Wo          , Wo          , Wo          , Wo          , Wo          , Wo          , Ww          , Ww          , Dd          , Ww          , Gs          , Gs          , Gs          , Hd          , Md          , Md          , Md          , Md          , Md          , Md          , Md          , Md          , Md          , Md          , Hd          , Hd          , Gs          , Gs          , Gs          , Gs          , Gs^Ftd      , Dd          , Dd^Vda      , Dd          , Dd          
Ds          , Wo          , Wo          , Wo          , Wo          , Wo          , Wo          , Wo          , Wo          , Wo          , Wo          , Wo          , Ww          , Ww^Vm       , Ww          , Gs          , Ss          , Gs          , Gs          , Gs          , Hd          , Hd^Es       , Md          , Md          , Ww^Ewf      , Md          , Md          , Md          , Md          , Hd^Es       , Hd          , Hd          , Dd          , Gs          , Gs          , Gs          , Gs          , Gs          , Gs          , Dd          , Gs^Ft       , Gs          
Ds          , Ds          , Ds^Ft       , Wo          , Wo          , Wo          , Wo          , Wo          , Wo          , Wo          , Wo          , Ww          , Ww          , Ww          , Ww          , Gs          , Ss          , Gs          , Gs          , Gs          , Hd          , Md          , Ww^Ewf      , Ww          , Ww          , Md          , Md          , Md          , Hd          , Hd          , Hd          , Dd          , Dd          , Gs          , Gs          , Ch          , Kh          , Ch          , Gs          , Gs          , Gs          , Gs          
Ds^Ft       , Ds^Ft       , Ds^Ft       , Ds^Ft       , Wo          , Wo          , Wo          , Wo          , Wo          , Wo          , Wo          , Ww          , Ww          , Ww          , Dd          , Ww^Ftd      , Dd          , Ww          , Gs          , Hd          , Hd          , Hd          , Md          , Ww          , Ww          , Ww          , Md          , Hd^Es       , Hd          , Hd          , Gs          , Dd          , Dd          , Gs          , Gs          , Ch          , Ch          , Ch          , Gs          , Gs          , Gs          , Gs          
Ds^Ft       , Ds^Ft       , Ds^Ft       , Ds^Ft       , Wo          , Wo          , Wo          , Wo          , Wo          , Wo          , Ww          , Ww          , Ww          , Dd          , Dd          , Dd          , Ww^Es       , Ww          , Gs^Ft       , Hd          , Hd          , Hd          , Ww          , Ww          , Ww          , Ww          , Ww          , Hd          , Hd          , Dd          , Dd          , Dd          , Dd          , Gs          , Re          , Re          , Ch          , Dd          , Dd          , Dd          , Gs^Ft       , Gs          
Ds^Ft       , Ds^Ft       , Wwr         , Wwr         , Wo          , Wo          , Wo          , Wo          , Wo          , Ww          , Ww          , Ww          , Dd          , Gs          , Gs^Ft       , Dd          , Ww^Es       , Dd          , Gs^Ft       , Gs          , Hd          , Hd          , Ww          , Ww          , Ww          , Ww          , Ww          , Dd^Vdt      , Hd          , Dd          , Dd          , Dd          , Gs^Ft       , Gs          , Re          , Gs^Ft       , Dd          , Rd          , Rd          , Dd          , Rd          , Rd          
Wo          , Wwr         , Wwr^Ft      , Wwr^Ftd     , Wwr         , Ww^Vm       , Ww          , Wo          , Ww          , Ww          , Ww          , Dd          , Gs          , Gs          , Gs^Ft       , Dd^Vdt      , Ww^Es       , Dd          , Gs^Ft       , Gs          , Hd          , Hd          , Hd          , Hd          , Ww          , Ww          , Ww          , Hd          , Hd^Ft       , Dd          , Dd          , Dd          , Gs^Ft       , Gs^Vht      , Re          , Gs^Ft       , Dd          , Dd^Vda      , Dd          , Rd          , Dd          , Gs^Ft       
Wo          , Ww^Ft       , Wwr^Ftd     , Wwr^Ftd     , Wwr         , Wwr         , Ww          , Ww          , Ww          , Ww          , Ww          , Gg^Vh       , Gs          , Gs          , Gs          , Gs^Ft       , Ww          , Dd^Do       , Ww          , Ww          , Ww          , Hd          , Hd          , Hd          , Hd          , Ww          , Ww          , Hd^Ft       , Gs^Ft       , Gs^Ft       , Gs^Ft       , Dd          , Dd          , Gs^Ft       , Rd          , Gs^Ft       , Gs^Ft       , Dd          , Dd          , Dd          , Dd          , Ds          
Ww^Ftd      , Dd^Do       , Wwr^Ftd     , Wwr^Ftd     , Wwr         , Ww          , Ww          , Ww          , Ww          , Ww          , Dd          , Gs^Ft       , Gs          , Gs          , Gs          , Gs          , Ww          , Ww          , Gg^Vh       , Ww          , Ww          , Hd          , Hd          , Hd          , Ww          , Ww          , Chw^Ft      , Hd^Ft       , Gs          , Gs          , Gs          , Gs^Ft       , Dd          , Gs^Ft       , Gs          , Re          , Gs          , Dd          , Dd          , Dd          , Gg^Efm      , Gg^Efm      
Wo          , Ww^Ftd      , Ww^Ftd      , Ww^Ftd      , Wwr         , Ww          , Ww          , Ww          , Ww          , Dd          , Dd          , Dd          , Rd          , Gs^Ft       , Gs          , Ww          , Ww          , Ww^Ewf      , Gs          , Gs          , Ww          , Hd          , Hd          , Ww          , Ww          , Ww          , Chw         , Gs^Ft       , Gs          , Gs          , Re          , Re          , Re          , Gs          , Re          , Re          , Re          , Gs          , Gg^Ve       , Gg^Efm      , Gg^Efm      , Gg^Efm      
Wo          , Ww          , Ww          , Ww          , Ww          , Ww          , Dd          , Dd          , Dd          , Dd^Ecf      , Dd          , Dd          , Rd          , Dd          , Dd          , Ww          , Ww          , Gs          , Gs          , Gs          , Ww          , Ww          , Ww          , Ww^Bw\      , Rd          , Wwf         , Ch          , Re          , Re          , Re          , Gs          , Gs          , Gs          , Re          , Gs          , Gs          , Re          , Gs          , Gg^Efm      , Gg^Efm      , Gs^Ft       , Gs^Ft       
Wo          , Wo          , Ww          , Ww          , Ww^Ft       , Gg^Vh       , Gs          , Dd          , Dd          , Dd          , Rd          , Rd          , Dd          , Dd          , Dd          , Dd          , Gs^Ftp      , Gs          , Gs          , Gs          , Ww          , Ww          , Ww          , Ww          , Hd          , Kh          , Rd          , Hd          , Hd          , Hd          , Hd          , Hd          , Hd          , Gs          , Gs          , Gs          , Gs          , Re          , Re          , Gs^Ft       , Dd          , Dd          
Wo          , Wo          , Ww          , Ww^Ft       , Gs^Ft       , Gs          , Gs          , Gs          , Gs^Ft       , Rd          , Gs^Ft       , Hd          , Hd          , Dd          , Hd          , Hd          , Gs^Ftp      , Gs^Ftp      , Gs          , Hd          , Ww          , Hd          , Hd          , Dd^Vdt      , Hd          , Hd          , Rd          , Hd          , Hd          , Hd          , Hd          , Hd          , Hd          , Gs          , Hd          , Hd          , Gs          , Gs          , Rd          , Gs^Ft       , Dd          , Dd          
Ww          , Ww          , Ww          , Dd          , Gs^Ft       , Gs^Ft       , Gs          , Gs          , Gs          , Hd          , Hd          , Hd          , Ww          , Ww          , Hd          , Hd          , Hd          , Gs          , Hd          , Hd          , Ww          , Hd          , Hd          , Hd          , Rd          , Rd          , Hd          , Hd          , Hd          , Hd          , Hd          , Hd          , Hd          , Hd          , Hd          , Hd          , Hd          , Hd          , Rd          , Dd          , Dd^Vct      , Md          
Ww          , Ww          , Ww          , Dd          , Gs^Ft       , Gs^Ft       , Gs          , Gs          , Hd          , Hd          , Dd^Vdt      , Hd          , Ww          , Ww          , Ww          , Hd          , Hd          , Hd          , Hd          , Ww          , Hd          , Hd          , Hd          , Hd          , Rd          , Hd^Vhh      , Xuc         , Hd          , Hd          , Hd          , Hd^Es       , Xu          , Ur          , Hd          , Hd          , Hd          , Hd          , Rd          , Hhd         , Hhd         , Md          , Md          
Ww          , Ww          , Ww          , Dd          , Dd          , Dd^Vdt      , Gs          , Gs          , Hd          , Ww          , Ww          , Ww          , Ww          , Ww          , Ww          , Ww          , Ww          , Ww          , Ww          , Ww          , Hd          , Hd          , Rd          , Rd          , Xuc         , Xuc         , Kud         , Xuc         , Xuc         , Xu          , Xuc         , Xuc         , Ur          , Xu          , Xu          , Hd          , Hd          , Rd          , Hhd         , Md          , Md          , Md          
Ww^Vm       , Ww          , Ww          , Dd          , Dd          , Dd          , Rd          , Hd          , Hd          , Md          , Ww          , Ww          , Ww          , Ww          , Ww          , Ww          , Ww          , Hd          , Ww          , Hd          , Rd          , Rd          , Xu          , Xu          , Xu          , Cud         , Cud         , Cud         , Xuc         , Xuc         , Ur          , Ur          , Ur          , Ur          , Ur^Vud      , Xu          , Hhd         , Rd          , Hhd         , Md          , Dd          , Dd^Vct      
Ww          , Ww          , Ww          , Dd          , Rd          , Rd          , Dd          , Hd          , Md          , Ww          , Ww          , Ww          , Ww          , Ww          , Ww          , Hd          , Hd          , Hd          , Ch          , Rd          , Hd          , Xu          , Xu          , Uu^Vu       , Xuc         , Xuc         , Ur          , Ur          , Ur          , Ur          , Ur          , Ur          , Xu          , Xu          , Xu          , Xu          , Hhd^Vhh     , Rd          , Rd          , Dd          , Dd          , Dd          
Ww          , Ww          , Ww          , Dd^Vda      , Rd          , Dd          , Dd          , Ww^Es       , Ww          , Ww          , Ww          , Ww          , Ww          , Ww          , Ww          , Hd          , Hd          , Ch          , Ch          , Kh          , Hd          , Hhd^Vhh     , Ur          , Uu          , Xuc         , Ur          , Ur          , Ur          , Ur          , Ur          , Ur          , Uu^Emf      , Uh^Emf      , Xu          , Xu          , Xuc         , Xuc         , Hhd         , Rd          , Hd          , Hd          , Hd          
Ww          , Ww          , Ww          , Dd          , Rd          , Dd          , Dd          , Hd          , Ww          , Ww          , Ww          , Ww          , Ww          , Ww          , Ww          , Hd          , Dd^Vdt      , Ww          , Ww^Bw|      , Ww          , Hd          , Xu          , Ur          , Ur          , Ur          , Ur          , Xuc         , Xuc         , Xu          , Xu          , Xu          , Ur          , Ur          , Xuc         , Cud         , Kud         , Cud         , Xuc         , Rd          , Hd          , Hd          , Hd          
Ww          , Ww          , Ww          , Dd          , Dd          , Rd          , Dd          , Dd          , Ww          , Ww          , Ww          , Ww          , Ww          , Ww          , Hd          , Ww          , Ww          , Ww          , Rr          , Hd          , Xu          , Xu          , Ur          , Ur          , Xuc         , Ur          , Xuc         , Xu          , Urb         , Urb         , Xu          , Xu          , Xu          , Ur          , Cud         , Xuc         , Xuc         , Ch          , Rd          , Rd          , Rd          , Dd^Es       
Ww          , Ww          , Ww          , Dd          , Gs^Ft       , Rd          , Dd          , Gs^Ft       , Ww^Ftp      , Dd^Do       , Ww          , Ww          , Ww          , Hd          , Hd          , Ww          , Hd          , Rr          , Hd          , Hd          , Xu          , Qxu         , Qxu^Bs|     , Ur          , Ur          , Ur^Vu       , Xu          , Urb         , Xu          , Urb         , Xu          , Ur^Vud      , Ur          , Xuc         , Ur          , Xuc         , Rd          , Rd          , Mm          , Ch          , Mm          , Dd          
Ww          , Ww          , Ww          , Ww          , Dd          , Gs          , Gs^Ft       , Gs          , Gs          , Dd^Vda      , Dd          , Ww          , Dd          , Gs^Ft       , Hd          , Hd          , Hd          , Rr          , Hd          , Hd          , Xu          , Uu          , Uu          , Xu          , Xu          , Xu          , Cud         , Urb         , Xu          , Urb         , Xu          , Xu          , Ur          , Ur          , Ur          , Xu          , Rd          , Mm          , Mm          , Mm          , Mm          , Mm          
Ww          , Ww          , Ww          , Ww          , Ww          , Gs          , Gs          , Gs^Ft       , Gs^Ft       , Dd          , Dd          , Ww          , Ww          , Dd          , Gs^Ft       , Hd          , Hd          , Rr          , Hd          , Hd          , Hhd         , Xu          , Xu          , Qxu^Bs\     , Uu          , Xu          , Ur          , Xu          , Uu^Vu       , Cud         , Uu          , Qxu         , Uu          , Xu          , Xu          , Xu          , Rd          , Mm^Xm       , Mm          , Mm          , Mm^Xm       , Mm^Xm       
Wo          , Ww          , Ww          , Ww          , Ww          , Ww          , Dd^Vda      , Gs^Ft       , Dd          , Dd          , Dd          , Dd          , Dd          , Ww          , Dd          , Gs^Ft       , Gg^Vh       , Rr          , Gs          , Hd          , Hd          , Xu          , Xu          , Qxu         , Uu          , Uu          , Ur          , Qxu         , Qxu         , Xu          , Uu^Emf      , Uu          , Xu          , Xu          , Dd^Es       , Dd          , Md^Xm       , Mm          , Mm          , Mm          , Mm          , Mm          
Wo          , Ww          , Ww          , Ww          , Ww          , Ww          , Dd          , Rd          , Rd          , Dd          , Dd          , Dd          , Dd          , Ww          , Dd          , Dd          , Rp          , Rp          , Gs          , Hd          , Hd          , Xu          , Xu          , Uu          , Ur          , Ur          , Xu          , Xu          , Xu          , Xu          , Xu          , Xu          , Xu          , Hd^Eff      , Hd^Eff      , Md          , Mm^Xm       , Mm^Xm       , Mm          , Mm          , Mm          , Mm          
Wo          , Wo          , Wo          , Ww          , Ww          , Ww          , Ww          , Dd          , Dd^Do       , Rd          , Rd          , Dd          , Dd          , Ww          , Dd          , Rr          , Gs^Ft       , Gs          , Gs          , Gs          , Dd^Vc       , Hd          , Xu          , Ur          , Xu          , Qxu         , Xu          , Xu          , Hh^Ftp      , Hh^Ftp      , Hh^Ftp      , Xu          , Hh^Ft       , Hd^Es       , Hd^Es       , Md          , Mm          , Mm          , Mm          , Mm          , Mm          , Mm          
Wo          , Wo          , Wo          , Wo          , Wo          , Ww          , Ww          , Ww          , Ww          , Dd^Ftd      , Dd^Ftd      , Rd          , Rd          , Ww          , Dd          , Rr          , Dd          , Gs          , Gs          , Gs          , Hd^Eff      , Hd^Eff      , Dd^Edpp     , Hh^Ft       , Hh^Ft       , Xu          , Hh^Ftp      , Hh^Ftp      , Hh^Ftp      , Hh^Ftp      , Hh^Ftp      , Hh^Ftp      , Hh^Ft       , Hh^Ft       , Hh^Ft       , Hh^Ft       , Mm          , Mm          , Mm          , Mm          , Mm          , Mm^Xm       
Wo          , Wo          , Wo          , Wo          , Wo          , Wo          , Wo          , Ww          , Ww          , Ww          , Ww          , Dd^Ftd      , Ww          , Ww^Bw\      , Rr          , Rr          , Dd          , Gs          , Gs          , Gs          , Dd^Ftd      , Hd^Eff      , Hd^Eff      , Hh^Ft       , Hh^Ft       , Hh^Ftp      , Hh^Ftp      , Hh^Ftp      , Hh^Ftp      , Hh^Ftp      , Hh^Ftp      , Hh^Ftp      , Mm          , Hh^Ft       , Hh^Ft       , Mm          , Mm          , Mm          , Mm          , Mm          , Mm          , Mm          
Wo          , Wo          , Wo          , Wo          , Ww          , Ww          , Ww          , Ww          , Ww          , Ww          , Gs^Ftp      , Ww          , Ww          , Dd^Vda      , Rr          , Dd          , Gs          , Gs          , Gs          , Gs          , Gs^Eff      , Dd^Eff      , Hh^Ft       , Hh^Ft       , Hh^Ft       , Hh^Ftp      , Hh^Ftp      , Hh^Ftp      , Mm          , Hh^Ftp      , Mm          , Mm          , Mm          , Hh^Ft       , Mm          , Mm          , Mm          , Mm          , Mm          , Mm          , Mm          , Mm          
Wo          , Wo          , Wo          , Wo          , Ww          , Ww          , Ww          , Ww          , Ww          , Dd          , Gs          , Gs^Ftp      , Gs^Ftp      , Dd          , Rr          , Dd          , Gs          , Gs          , Gs          , Gs^Ft       , Gs^Ft       , Gs^Eff      , Dd^Eff      , Hh^Ft       , Hh^Ft       , Hh^Ft       , Hh^Ft       , Hh^Ft       , Hh^Ft       , Mm          , Mm          , Hh^Ftr      , Hh^Ftr      , Mm          , Mm          , Mm          , Mm          , Mm          , Mm          , Mm          , Mm          , Mm          
Wo          , Wo          , Wo          , Ww          , Ww          , Ww          , Ww          , Ww          , Dd          , Gs          , Gs          , Gs          , Rp          , Rr^Vhc      , Rr          , Gs^Ft       , Gs^Vht      , Gs^Ft       , Gs^Ftp      , Dd          , Gs^Ft       , Gs          , Gs^Eff      , Gs^Eff      , Hh^Ft       , Hh^Ft       , Gs^Ft       , Gs^Ft       , Hh^Ft       , Hh^Ft       , Hh^Ft       , Hh^Ftr      , Hh^Ftr      , Hh^Ftr      , Hh^Ftr      , Mm          , Hh^Vo       , Mm          , Mm          , Mm          , Mm          , Mm          
Wo          , Wo          , Ww          , Ww          , Ww          , Ww          , Ww          , Ww          , Dd          , Gs          , Rp          , Rp^Vhc      , Rr          , Rr          , Rp          , Rp          , Gs^Ft       , Dd          , Dd^Ecf      , Dd          , Gs^Ft       , Gs          , Gs          , Gs^Eff      , Gs^Eff      , Gs^Ft       , Gs^Ft       , Gs^Ft       , Gs^Ft       , Gs^Ft       , Gs^Ft       , Gs^Ft       , Gs^Ft       , Gs^Ftr      , Hh^Ftr      , Hh^Ftr      , Mm          , Mm          , Mm          , Mm          , Mm          , Mm^Xm       
Wo          , Wo          , Ww          , Ww          , Ww          , Ww          , Ww          , Ww          , Gs          , Rp          , Rr          , Rr          , Rr          , Rr          , Rr^Vhc      , Gs          , Gs^Ftp      , Dd          , Dd          , Dd          , Gs^Ft       , Gs          , Gs          , Gs          , Gs^Eff      , Gs^Eff      , Gs^Ft       , Gs^Ft       , Gs^Ft       , Gs^Ft       , Gs^Ft       , Gs^Ft       , Gs^Ft       , Gs^Ftr      , Hh^Ftr      , Hh^Ftr      , Mm          , Mm          , Mm          , Mm          , Mm          , Mm          
Wo          , Wo          , Ww          , Ww          , Ww          , Ww          , Ww          , Dd^Vda      , Gs          , Rp          , Ch          , Ch          , Rr          , Rr          , Gs          , Gs          , Gs^Ftp      , Gs^Ftp      , Gs^Ftp      , Gs^Ft       , Gs          , Gs          , Gs          , Gs          , Gs          , Gs^Eff      , Gs^Eff      , Gs^Ft       , Gs^Ft       , Gs^Ft       , Gs^Ft       , Gs^Ft       , Gs^Ft       , Gs^Ft       , Hh^Ftr      , Hh^Ftr      , Mm          , Mm          , Mm          , Mm          , Mm          , Mm          
Wo          , Wo          , Ww          , Ww          , Ww          , Ww          , Ww          , Ww          , Ww^Ftp      , Ch          , Kh          , Ch          , Rp          , Gs          , Gs          , Gs^Ft       , Gs^Gvs      , Gs^Gvs      , Gs^Gvs      , Gs^Gvs      , Gs          , Gs          , Gs          , Gs          , Gs          , Gs^Eff      , Gs^Eff      , Gs^Ft       , Gs^Ft       , Gs^Ft       , Gs^Ft       , Gs^Ft       , Hh^Ft       , Hh^Ft       , Mm          , Mm          , Mm          , Mm          , Mm          , Mm          , Mm          , Mm          
Wo          , Wo          , Ww          , Ww          , Ww          , Ww          , Ww^Ft       , Ww^Ftp      , Gs          , Gg^Fet      , Ch          , Ch          , Gs          , Rp          , Rp          , Gs^Ft       , Gs^Gvs      , Gs^Gvs      , Gs          , Gs          , Gs          , Gs          , Gs          , Gs          , Gs^Vht      , Gs^Ft       , Gs          , Gs^Eff      , Gs^Eff      , Gs^Eff      , Dd^Vdt      , Hh^Ft       , Mm          , Mm          , Mm          , Mm          , Mm          , Mm          , Hh^Ft       , Hh^Ft       , Mm          , Mm          
Wo          , Wo          , Ww          , Ww          , Ww          , Ww          , Ww^Ft       , Ww^Ft       , Gs^Ft       , Dd^Ftd      , Dd^Ftd      , Dd          , Dd          , Dd          , Gs^Ft       , Gs^Ft       , Rp^Vht      , Gs          , Re          , Re          , Re          , Gs          , Gs^Ft       , Gs^Ft       , Gs          , Gs^Ft       , Gs^Ft       , Gs          , Gs          , Dd          , Hd          , Mm          , Mm          , Mm          , Ww          , Wwf         , Hh          , Hh          , Gs          , Gs          , Gs          , Mm          
Wo          , Wo          , Ww          , Ww          , Ww          , Ww          , Ww^Ft       , Ww^Ftp      , Dd^Ftp      , Dd          , Dd^Ft       , Dd^Ft       , Dd          , Dd          , Rd          , Dd          , Gs^Ft       , Rp          , Hd          , Hd          , Gs^Ft       , Re          , Rd          , Gs^Ft       , Gs          , Gs          , Gs^Ft       , Gs^Ft       , Wo          , Dd          , Wo          , Mm          , Wo          , Wo          , Hh          , Hh          , Hh          , Hh          , Gs          , Hh^Ft       , Hh          , Hh          
Wo          , Wo          , Ww          , Ww          , Ww          , Ww          , Ww^Ft       , Ww^Ft       , Dd^Vda      , Dd          , Dd          , Dd          , Dd          , Rd          , Dd          , Dd          , Dd          , Gs          , Hd          , Hd^Ft       , Hd^Ft       , Dd          , Dd          , Rd          , Re          , Gs          , Wwf         , Wo          , Gs^Ft       , Wo          , Wo          , Wo          , Hh^Ft       , Hh^Ft       , Hh          , Hh          , Hh^Ft       , Hh^Ft       , Gs          , Hh^Ft       , Hh          , Hh^Ft       
Wo          , Wo          , Ww          , Ww          , Ww          , Ww          , Ww          , Ww^Ft       , Ww^Ftd      , Dd          , Dd          , Dd          , Rd          , Rd          , Dd          , Dd          , Dd          , Dd          , Hd          , Hd          , Hd^Ft       , Dd          , Dd          , Dd^Ft       , Gs^Ft       , Re          , Ww          , Mm          , Mm          , Dd          , Gs^Ft       , Wo          , Wo          , Hh^Ft       , Hh          , Hh          , Gs          , Gs          , Hh^Ft       , Hh^Ft       , Hh^Ft       , Ww          
