border_size=1
usage=map

          Xu,           Xu, Xu          , Xu          , Xu          ,           Xu,           Xu,           Xu,           Xu,           Xu,           Xu,           Xu, Xu          , Xu          , Xu          , Wo          , Wo          , Wo          , Wo          , Wo          , Wo          , Wo          , Wo          , Wo          , Hh^Vc       , Chw         , Khr         , Wo          , Wo          , Cud         , Cud         , Xu          
          Xu,           Xu, Xu          , Wo          , Wo          ,           Xu,           Xu,           Xu,           Xu,           Xu,           Xu,           Xu, Xu          , Xu          , Wo          , Wo          , Xu          , Wo          , Xu          , Wo          , Wo          , Wo          , Xu          , Xu          , Uh^Dr       , Xu          , Cud         , Xu          , Wo          , Xu          , Kud         , Ur          
          Xu,           Xu, Wo          , Xu          , Wo          , Xu          , Xu          ,           Xu,           Xu,           Xu, Xu          , Xu          , Wo          , Wo          , Xu          , Xu          , Urb^Vud     , Xu          , Cud         , Xu          , Xu          , Xu          , Uue^Uf      , Uue         , Uue         , Xu          , Cud         , Xu          , Wo          , Xu          , Xu          , Uu          
Xu          , Xu          , Wo          , Wo          , Xu          , Wo          , Wo          , Xu          , Xu          , Xu          , Xu          , Wo          , Cud         , Cud         , Urb         , Urb         , Urb         , Urb         , Xu          , Uh          , Uu^Emf      , Uue^Uf      , Uue         , Uue         , Uue         , Xu          , Wo          , Xu          , Xu          , Wo          , Xu          , Uu          
Xu          , Wo          , Wo          , Xu          , Xu          , Xu          , Xu          , Wo          , Wo          , Xu          , Xu          , Wo          , Cud         , Urb         , Urb         , Urb         , Urb         , Cud         , Xu          , Xu          , Xu          , Uu          , Uu          , Xuce        , Uue         , Xu          , Xu          , Wo          , Wo          , Wo          , Wo          , Xu          
          Xu, Xu          , Xu          , Wo          , Wwf         , Xu          ,           Xu, Xu          , Wo          , Wo          , Wo          , Wo          , Cud         , 2 Kud       , Urb         , Urb         , Cud         , Xu          , Xu          , Wo          , Wo          , Xu          , Ur^Vud      , Uu          , Uu          , Xu          , Wo          , Xu          , Xu          , Xu          , Xu          , Wo          
          Xu,           Xu,           Xu, Xu          , Xu          , Xu          ,           Xu, Xu          , Xu          , Xu          , Xu          , Wo          , Xu          , Xu          , Xu          , Xu          , Uu^Uf       , Uh          , Uu          , Xu          , Xu          , Xu          , Xu          , Ur          , Ur          , Xu          , Xu          , Wo          , Xu          , Xu          , Xu          , Wo          
          Xu,           Xu,           Xu, Xu          ,           Xu,           Xu, Xu          , Xu          , Wo          , Wo          , Wo          , Wo          , Wo          , Wo          , Wo          , Xu          , Xu          , Xu          , Uu^Emf      , Uu          , Uu          , Xu          , Wo          , Xu          , Xu          , Ur          , Ur          , Xu          , Xu          , Xu          , Wo          , Wo          
          Xu,           Xu,           Xu,           Xu, Xu          , Xu          , Wo          , Wo          , Wo          , Wo          , Co          , Ss          , Co          , Wo          , Wo          , Ss          , Ss          , Xu          , Xu          , Uu^Uf       , Uu          , Xu          , Xu          , Wo          , Wo          , Ur^Ii       , Ur^Ii       , Xu          , Wo          , Wo          , Xu          , Xu          
          Xu,           Xu,           Xu,           Xu, Xu          , Wo          , Wo          , Wo          , Wo          , Wo          , Ss          , 4 Ko        , Rr^Vd       , Wo          , Wo          , Wo          , Wo          , Wwf         , Xu          , Uu^Uf       , Ur^Vud      , Uu          , Ur          , Xu          , Xu          , Wo          , Ur^Ii       , Xu          , Wo          , Xu          , Xu          , Xu          
          Xu,           Xu,           Xu,           Xu, Xu          , Wo          , Wo          , Wo          , Wo          , Wo          , Ww          , Ww          , Ww          , Wo          , Wo          , Wo          , Wo          , Wo          , Xu          , Xu          , Xu          , Ur          , Xu          , Cud         , Cud         , Xu          , Cud         , Xu          , Xu          , Wo          , Wo          , Wo          
          Xu,           Xu, Xu          , Xu          , Wo          , Wo          , Wo          , Wo          , Wo          , Wo          , Ww          , Ww^Fet      , Ww          , Wo          , Wo          , Wo          , Wo          , Wo          , Wo          , Xu          , Xu          , Xu          , Xu          , Xu          , Xu          , Cud         , Cud         , Cud         , Xu          , Xu          , Wo          , Wo          
          Xu,           Xu, Xu          , Wo          , Wo          , Wo          , Wo          , Ww^Vm       , Ww          , Ww          , Ww          , Ww^Bw|r     , Ww          , Ww          , Ww          , Ww^Vm       , Wo          , Wo          , Wo          , Wo          , Xu          , Xu          , Xu          , Wo          , Wo          , Xu          , Xu          , Cud         , Cud         , Xu          , Wo          , Wo          
          Xu,           Xu, Xu          , Wo          , Wo          , Wo          , Wo          , Wo          , Ww          , Ww          , Chw         , Chw         , Chw         , Ww          , Ww          , Wo          , Wo          , Wo          , Wo          , Wo          , Xu          , Xu          , Xu          , Wo          , Wo          , Wo          , Xu          , Xu          , Cud         , Xu          , Xu          , Wo          
          Xu, Xu          , Wo          , Wo          , Wo          , Wo          , Wo          , Ww          , Chw         , Chw         , Khw         , Khw         , Khw         , Chw         , Chw         , Ww          , Wo          , Wo          , Wo          , Wo          , Wo          , Xu          , Xu          , Wo          , Wo          , Xu          , Xu          , Ql          , Ql^Bs|      , Ql^Bs\      , Uu^Vu       , Xu          
          Xu, Xu          , Wo          , Chr         , Wo^Bw\      , Wo          , Wo^Bw/      , Ww^Bw/      , Chw         , Khw         , Khw         , 3 Khw       , Khw         , Khw         , Chw         , Ww^Bw\      , Wo^Bw\      , Wo          , Wo^Bw/      , Ch          , Wo          , Xu          , Xu          , Xu          , Xu          , Wo          , Wo          , Ql          , Uu          , Ql^Bs/      , Xu          , Xu          
Cud         , Xu          , Wo          , Wo          , Wo          , Ww^Vm       , Wo          , Ww          , Chw         , Khw         , Khw         , Ql          , Khw         , Khw         , Chw         , Ww          , Wo          , Ww^Vm       , Wo          , Wo          , Wo          , Xu          , 5 Kud       , Cud         , Cud         , Xu          , Uu^Emf      , Uu^Ii       , Uu          , Xu          , Wo          , Wo          
Ur          , Xu          , Wo          , Wo          , Wo          , Wo^Bh|      , Wo          , Ww          , Chw         , Khw         , Khw         , Khw         , Khw         , Khw         , Chw         , Ww          , Wo          , Wo^Bh|      , Wo          , Wo          , Wo          , Xu          , Cud         , Cud         , Ur          , Uu          , Uu          , Uu          , Uu^Uf       , Xu          , Wo          , Wo          
Ur          , Xu          , Xu          , Wo          , Wo          , Wo^Bh|      , Wo^Bw/      , Ww^Bw/      , Ww          , Chw         , Chw         , Khw         , Chw         , Chw         , Ww          , Ww^Bw\      , Wo^Bw\      , Wo^Bh|      , Wo          , Wo          , Xu          , Xu          , Cud         , Ur          , Xu          , Uu^Vu       , Xu          , Xu          , Xu          , Xu          , Wo          , Wo          
Ql          , Ur          , Xu          , Wo          , Wo          , Ww^Vm       , Ww^Bw\      , Wo          , Wo          , Ww          , Ww          , Chw         , Ww          , Ww          , Wo          , Wo          , Wo^Bw/      , Ww^Vm       , Wo          , Wo          , Xu          , Xu          , Uu          , Ur          , Xu          , Xu          , Wo          , Wo          , Wo          , Xu          , Wo          , Wo          
Ql^Bs/      , Ur          , Xu          , Wo          , Wo          , Wo          , Ww          , Wo^Bw\      , Wo^Bw\      , Wo          , Wo          , Ww^Bw|      , Wo          , Wo          , Wo^Bw/      , Ww^Vm       , Ss          , Ss          , Ss          , Wwf         , Xu          , Xu          , Uh          , Ur          , Uu^Em       , Wo^Ii       , Xu          , Xu          , Xu          , Wo          , Xu          , Wo          
Ql          , Ur          , Ur          , Xu          , Wo          , Wo          , Wo          , Ww          , Ww          , Wo^Bw\      , Ww^Bw\      , Wo^Bw|      , Wo^Bw/      , Wo^Bw/      , Ss          , Ss          , Ss          , Ss          , Ss          , Xu          , Xu          , Xu          , Uu^Em       , Ur          , Xu          , Xu          , Xu          , Xu          , Xu          , Xu          , Xu          , Xu          
Uu          , Ql^Bs/      , Ur          , Xu          , Xu          , Wo          , Wo          , Ww          , Ww          , Ww          , Ww          , Ww^Vm       , Wo          , Wo          , Wo          , Ss          , Ss          , Ss          , Xu          , Xu          , Xu          , Uh          , Ur          , Ur          , Cud         , Cud         , Ur^Em       , Ur^Em       , Ur^Em       , Uu^Uf       , Uu^Emf      , Xu          
Ql^Xo       , Ql          , Ur          , Xu          , Xu          , Wo          , Wo          , Wo          , Wo          , Ww          , Wo          , Ww^Bw|      , Wwf         , Wo          , Ss          , Ss          , Ss          , Ss          , Xu          , Xu          , Ur          , Ur          , Ur          , Xu          , Xu          , Xu          , Xu          , Uu^Emf      , Ur^Em       , Ur^Em       , Uu^Vud      , Ur^Em       
Xu          , Ur^Vud      , Xu          , Ur          , Ur          , Xu          , Xu          , Wo          , Xu          , Wo          , Xu          , Ww^Bw|      , Xu          , Wwf         , Mm^Vc       , Ss          , Xu          , Xu          , Xu          , Ur          , Ur          , Ur          , Xu          , Xu          , Wo          , Xu          , Xu          , Uu^Uf       , Uu^Uf       , Uu^Uf       , Xu          , Xu          
Xuc         , Xu          , Xu          , Xu          , Ur          , Ur          , Xu          , Xu          , Xu          , Xos         , Cud         , Cud         , Cud         , Xos         , Xu          , Xu          , Uu^Uf       , Uu^Emf      , Uu          , Cud         , Cud         , Xu          , Xu          , Wo^Es       , Xu          , Wo          , Xu          , Xu          , Xu          , Xu          , Xu          , Xu          
Cud         , Xuc         , Xuc         , Xu          , Xu          , Cud         , Ur          , Ur          , Ur          , Cud         , Cud         , 1 Kud       , Cud         , Cud         , Ur          , Ur          , Ur          , Uu          , Uu          , Uu^Emf      , Uu^Uf       , Xu          , Cud         , Xu          , Wo          , Wo          , Xu          , Xu          , Xu          , Xu          , Wo          , Wo          
Xuc         , Hh^Ii       , Xu          , Xu          , Xu          , Ur^Vud      , Xu          , Ur          , Ur          , Ur          , Ur          , Cud         , Ur          , Ur          , Ur          , Ur          , Xu          , Xu          , Xu          , Uu^Vud      , Xu          , Xu          , Uue         , Xu          , Xu          , Wo          , Wo          , Xu          , Wo          , Wo          , Xu          , Xu          
Xu          , Xu          , Wo          , Xu          , Uue         , Xu          , Uue^Vud     , Xu          , Xu          , Ur          , Ur          , Ur          , Ur          , Ur          , Xu          , Xu          , Xu          , Xu          , Xu          , Xu          , Uue^Emf     , Uue         , Ww          , Xu          , Wo          , Wo          , Wo          , Wo          , Xu          , Xu          , Xu          , Uue^Uf      
Wo          , Wo          , Wo          , Xu          , Xu          , Uue^Ufi     , Xu          , Xu          , Xu          , Xu          , Xu          , Xu          , Xu          , Xu          , Xu          , Xu          , Wo          , Wo^Es       , Wo          , Uue^Ii      , Xu          , Ww^Vm       , Wo          , Wo          , Wo          , Wo          , Xu          , Xu          , Xu          , Wwf^Es      , Wo          , Xu          
