border_size=1
usage=map

Ww          , Ww          , Ww          , Dd          , Gs          , Gs^Ftp      , Gs^Ftp      , Dd          , Rr          , Dd          , Gs          , Gs          , Gs          , Gs^Ft       , Gs^Ft       , Gs^Eff      , Dd^Eff      , Hh^Ft       , Hh^Ft       , Hh^Ft       , Hh^Ft       , Hh^Ft       , Hh^Ft       , Mm          , Mm          , Hh^Ftr      , Hh^Ftr      , Mm          , Mm          , Mm          , Mm          , Mm          
Ww          , Ww          , Dd          , Gs          , Gs          , Gs          , Rp          , Rr^Vhc      , Rr          , Gs^Ft       , Gs^Vht      , Gs^Ft       , Gs^Ftp      , Dd          , Gs^Ft       , Gs          , Gs^Eff      , Gs^Eff      , Hh^Ft       , Hh^Ft       , Gs^Ft       , Gs^Ft       , Hh^Ft       , Hh^Ft       , Hh^Ft       , Hh^Ftr      , Hh^Ftr      , Hh^Ftr      , Hh^Ftr      , Mm          , Hh^Vo       , Mm          
Ww          , Ww          , Dd          , Gs          , Rp          , Rp^Vhc      , Rr          , Rr          , Rp          , Rp          , Gs^Ft       , Dd          , Dd^Ecf      , Dd          , Gs^Ft       , Gs          , Gs          , Gs^Eff      , Gs^Eff      , Gs^Ft       , Gs^Ft       , Gs^Ft       , Gs^Ft       , Gs^Ft       , Gs^Ft       , Gs^Ft       , Gs^Ft       , Gs^Ftr      , Hh^Ftr      , Hh^Ftr      , Mm          , Mm          
Ww          , Ww          , Gs          , Rp          , Rr          , Rr          , Rr          , Rr          , Rr^Vhc      , Gs          , Gs^Ftp      , Dd          , Dd          , Dd          , Gs^Ft       , Gs          , Gs          , Gs          , Gs^Eff      , Gs^Eff      , Gs^Ft       , Gs^Ft       , Gs^Ft       , Gs^Ft       , Gs^Ft       , Gs^Ft       , Gs^Ft       , Gs^Ftr      , Hh^Ftr      , Hh^Ftr      , Mm          , Mm          
Ww          , Dd^Vda      , Gs          , Rp          , Ch          , Ch          , Rr          , Rr          , Gs          , Gs          , Gs^Ftp      , Gs^Ftp      , Gs^Ftp      , Gs^Ft       , Gs          , Gs          , Gs          , Gs          , Gs          , Gs^Eff      , Gs^Eff      , Gs^Ft       , Gs^Ft       , Gs^Ft       , Gs^Ft       , Gs^Ft       , Gs^Ft       , Gs^Ft       , Hh^Ftr      , Hh^Ftr      , Mm          , Mm          
Ww          , Ww          , Ww^Ftp      , Ch          , 1 Kh        , Ch          , Rp          , Gs          , Gs          , Gs^Ft       , Gs^Gvs      , Gs^Gvs      , Gs^Gvs      , Gs^Gvs      , Gs          , Gs          , Gs          , Gs          , Gs          , Gs^Eff      , Gs^Eff      , Gs^Ft       , Gs^Ft       , Gs^Ft       , Gs^Ft       , Gs^Ft       , Hh^Ft       , Hh^Ft       , Mm          , Mm          , Mm          , Mm          
Ww^Ft       , Ww^Ftp      , Gs          , Gg^Fet      , Ch          , Ch          , Gs          , Rp          , Rp          , Gs^Ft       , Gs^Gvs      , Gs^Gvs      , Gs          , Gs          , Gs          , Gs          , Gs          , Gs          , Gs^Vht      , Gs^Ft       , Gs          , Gs^Eff      , Gs^Eff      , Gs^Eff      , Dd^Vdt      , Hh^Ft       , Mm          , Mm          , Mm          , Mm          , Mm          , Mm          
Ww^Ft       , Ww^Ft       , Gs^Ft       , Dd^Ftd      , Dd^Ftd      , Dd          , Dd          , Dd          , Gs^Ft       , Gs^Ft       , Rp^Vht      , Gs          , Re          , Re          , Re          , Gs          , Gs^Ft       , Gs^Ft       , Gs          , Gs^Ft       , Gs^Ft       , Gs          , Gs          , Dd          , Hd          , Mm          , Mm          , Mm          , Ww          , Wwf         , Hh          , Hh          
Ww^Ft       , Ww^Ftp      , Dd^Ftp      , Dd          , Dd^Ft       , Dd^Ft       , Dd          , Dd          , Rd          , Dd          , Gs^Ft       , Rp          , Hd          , Hd          , Gs^Ft       , Re          , Rd          , Gs^Ft       , Gs          , Gs          , Gs^Ft       , Gs^Ft       , Wo          , Dd          , Wo          , Mm          , Wo          , Wo          , Hh          , Hh          , Hh          , Hh          
Ww^Ft       , Ww^Ft       , Dd^Vda      , Dd          , Dd          , Dd          , Dd          , Rd          , Dd          , Dd          , Dd          , Gs          , Hd          , Hd^Ft       , Hd^Ft       , Dd          , Dd          , Rd          , Re          , Gs          , Wwf         , Wo          , Gs^Ft       , Wo          , Wo          , Wo          , Hh^Ft       , Hh^Ft       , Hh          , Hh          , Hh^Ft       , Hh^Ft       
Ww          , Ww^Ft       , Ww^Ftd      , Dd          , Dd          , Dd          , Rd          , Rd          , Dd          , Dd          , Dd          , Dd          , Hd          , Hd          , Hd^Ft       , Dd          , Dd          , Dd^Ft       , Gs^Ft       , Re          , Ww          , Mm          , Mm          , Dd          , Gs^Ft       , Wo          , Wo          , Hh^Ft       , Hh          , Hh          , Gs          , Gs          
Ww          , Ww^Ftd      , Ww          , Ww          , Wwr         , Dd          , Dd          , Dd          , Dd          , Dd          , Ww          , Wwr         , Wwr         , Wwf         , Hd          , Hd          , Hd          , Dd          , Ww          , Ww          , Ww          , Gs^Vct      , Mm          , Mm          , Mm          , Wwf         , Wo          , Wo          , Hh^Ft       , Hh          , Wo          , Wo          
Ww          , Ww          , Ww          , Ww          , Wwr         , Wwr         , Wwr         , Ww          , Ww          , Ww          , Ww          , Ww          , Dd^Ft       , Hd          , Hd^Ft       , Hd          , Ww          , Ww          , Gs^Ft       , Ww          , Ww^Ft       , Wwf         , Wo          , Mm          , Gs          , Xu          , Xu          , Wo          , Wo          , Wo          , Xu          , Xu          
Ww          , Ww          , Ww          , Ww          , Ww          , Wwr         , Wwr         , Ww          , Ds          , Ww          , Ds          , Dd          , Dd          , Hd          , Wwf         , Wwf         , Dd^Ft       , Dd^Ft       , Dd^Ft       , Gs^Ft       , Gs          , Gs^Ft       , Gs          , Wo          , Wo          , Xu          , Xu          , Xu          , Xu          , Xu          , Xu          , Xu          
Ww          , Ww          , Ww          , Ww          , Ds          , Wwr         , Ds          , Ds          , Ds          , Ds          , Ds          , Ds          , Dd          , Wwr         , Hd          , Dd          , Rd          , Dd^Vda      , Dd          , Dd^Ft       , Dd          , Gs^Ft       , Xu          , Xu          , Xu          , Wo          , Xu          , Xu          , Xu          , Xu          , Xu          , Hh          
Ww          , Ww          , Ww          , Ww          , Ds          , Ds          , Rd          , Ds          , Ds          , Ds          , Ds          , Dd          , Ww          , Ww          , Dd          , Dd          , Rd          , Dd          , Dd          , Dd          , Xu          , Xu          , Ur          , Ur^Ii       , Ur^Ii       , Wo          , Wo          , Xu          , Xu          , Xu          , Uu^Ii       , Uh^Ii       
Ww          , Ww          , Ww          , Ww          , Ds          , Ds          , Ds          , Ds          , Ds          , Ds          , Ww          , Ww          , Ww          , Dd          , Dd          , Dd          , Rd          , Dd          , Dd^Esd      , Xu          , Ur^Vud      , Ur          , Uu^Ufi      , Xu          , Xu          , Ur^Ii       , Xu          , Wwf         , Xue         , Uu          , Xue         , Uu^Ii       
Ww          , Ww          , Ww          , Ww          , Ds          , Ds          , Wwr         , Wwr         , Ww          , Ww          , Ww          , Ww          , Dd          , Dd          , Rd          , Rd          , Dd          , Dd          , Xu          , Xu          , Ur          , Ur          , Xu          , Wo^Ii       , Xu          , Xu          , Xue         , Xue         , Uue^Emf     , Uue^Ufi     , Wwf^Ii      , Xue         
Ww          , Ww          , Ww          , Ww          , Ds          , Wwr         , Wwr         , Wwr         , Wwr         , Ww          , Dd          , Dd          , Rd          , Rd          , Dd          , Dd          , Md          , Md          , Xu          , Xu          , Ur          , Ur          , Xu          , Wwf^Ii      , Wo^Ii       , Xue         , Xue         , Uue         , Xue         , Xue         , Wo^Ii       , Xu          
Wo          , Ww          , Ww          , Ww          , Ww          , Ww          , Ww          , Ww          , Dd          , Dd          , Dd          , Rd          , Dd^Esd      , Dd          , Md          , Md          , Md          , Md          , Xu          , Xu          , Ur          , Ur          , Xu          , Wo^Ii       , Xue         , Xue         , Uue         , Uue         , Xue         , Xue         , Xue         , Wo^Ii       
Wo          , Ww          , Ww          , Ww          , Ww          , Ww          , Dd          , Dd          , Rd          , Dd          , Dd          , Rd          , Dd^Esd      , Md          , Md          , Md          , Md          , Md          , Xuce        , Xue         , Ur          , Ur          , Uu^Uf       , Xu          , Xue         , Uue         , Xue         , Xue         , Xue         , Xue         , Xue         , Wo^Ii       
Wo          , Ww          , Ww          , Ww          , Ww          , Ww          , Ww          , Dd          , Dd          , Rd          , Dd          , Rd          , Hd^Esd      , Md          , Md          , Md          , Mm          , Md          , Xuce        , Ur^Vud      , Ur          , Ur          , Cud         , Xu          , Xue         , Uue         , Xue         , Wo^Ii       , Wo^Ii       , Xue         , Xu          , Xue         
Wo          , Wo          , Wo          , Ww          , Ww          , Ww          , Ww          , Dd          , Dd          , Dd          , Dd          , Dd^Dc       , Dd^Edpp     , Md          , Md          , Md          , Md          , Md          , Xuce        , Ur          , Ur          , Cud         , 2 Kud       , Cud         , Xue         , Uue         , Xue         , Wo^Ii       , Xue         , Xu          , Xu          , Xu          
Wo          , Wo          , Wo          , Ww          , Ww          , Ww          , Ww          , Ww          , Ww          , Dd          , Dd          , Rd          , Hd          , Md          , Md          , Md          , Md^Xm       , Md          , Xuce        , Ur          , Ur          , Cud         , Xue         , Xue         , Uue         , Uue         , Xue         , Xue         , Uu          , Ql^Bs/      , Ur          , Ur          
Wo          , Wo          , Wo          , Ww          , Ww          , Ww          , Ww          , Ww          , Ww          , Ww          , Dd          , Rd          , Hd          , Hd^Esd      , Hd^Esd      , Md^Xm       , Md^Xm       , Md^Xm       , Xue         , Ur^Vud      , Ur          , Xuce        , Xuce        , Uue^Uf      , Xue         , Xue         , Uu          , Uu          , Xu          , Ql^Bs\      , Ur          , Ur          
Wo          , Wo          , Wo          , Wo          , Wwt         , Ww          , Ww          , Ww          , Ww          , Ww          , Ww          , Dd          , Dd          , Hd          , Hd          , Hd^Esd      , Hd^Edpp     , Md^Xm       , Xu          , Xue         , Xuc         , Ur          , Ur          , Ur          , Xue         , Uu          , Xu          , Xu          , Wo^Ii       , Xu          , Xu          , Ur          
Wo          , Wo          , Wo          , Wo          , Wot         , Wwt         , Wwt         , Ww          , Ww          , Ww          , Ww          , Dd          , Rd          , Dd          , Hd          , Hd^Edpp     , Md          , Md^Xm       , Xu          , Xuc         , Xuc         , Ur          , Xuce        , Xue         , Ur          , Ur          , Xu          , Hh^Ii       , Wo^Ii       , Wo^Ii       , Wo^Ii       , Xu          
