border_size=1
usage=map

Ww          , Ww          , Ww          , Dd          , Gs          , Gs^Ftp      , Gs^Ftp      , Dd          , Rr          , Dd          , Gs          , Gs          , Gs          , Gs^Ft       , Gs^Ft       , Gs^Eff      , Dd^Eff      , Hh^Ft       , Hh^Ft       , Hh^Ft       , Hh^Ft       , Hh^Ft       , Hh^Ft       , Mm          , Mm          , Hh^Ftr      , Hh^Ftr      , Mm          , Mm          , Mm          , Mm          , Mm          
Ww          , Ww          , Dd          , Gs          , Gs          , Gs          , Rp          , Rr^Vhc      , Rr          , Gs^Ft       , Gs^Vht      , Gs^Ft       , Gs^Ftp      , Dd          , Gs^Ft       , Gs          , Gs^Eff      , Gs^Eff      , Hh^Ft       , Hh^Ft       , Gs^Ft       , Gs^Ft       , Hh^Ft       , Hh^Ft       , Hh^Ft       , Hh^Ftr      , Hh^Ftr      , Hh^Ftr      , Hh^Ftr      , Mm          , Hh^Vo       , Mm          
Ww          , Ww          , Dd          , Gs          , Rp          , Rp^Vhc      , Rr          , Rr          , Rp          , Rp          , Gs^Ft       , Dd          , Dd^Ecf      , Dd          , Gs^Ft       , Gs          , Gs          , Gs^Eff      , Gs^Eff      , Gs^Ft       , Gs^Ft       , Gs^Ft       , Gs^Ft       , Gs^Ft       , Gs^Ft       , Gs^Ft       , Gs^Ft       , Gs^Ftr      , Hh^Ftr      , Hh^Ftr      , Mm          , Mm          
Ww          , Ww          , Gs          , Rp          , Rr          , Rr          , Rr          , Rr          , Rr^Vhc      , Gs          , Gs^Ftp      , Dd          , Dd          , Dd          , Gs^Ft       , Gs          , Gs          , Gs          , Gs^Eff      , Gs^Eff      , Gs^Ft       , Gs^Ft       , Gs^Ft       , Gs^Ft       , Gs^Ft       , Gs^Ft       , Gs^Ft       , Gs^Ftr      , Hh^Ftr      , Hh^Ftr      , Mm          , Mm          
Ww          , Dd^Vda      , Gs          , Rp          , Ch          , Ch          , Rr          , Rr          , Gs          , Gs          , Gs^Ftp      , Gs^Ftp      , Gs^Ftp      , Gs^Ft       , Gs          , Gs          , Gs          , Gs          , Gs          , Gs^Eff      , Gs^Eff      , Gs^Ft       , Gs^Ft       , Gs^Ft       , Gs^Ft       , Gs^Ft       , Gs^Ft       , Gs^Ft       , Hh^Ftr      , Hh^Ftr      , Mm          , Mm          
Ww          , Ww          , Ww^Ftp      , Ch          , 1 Kh        , Ch          , Rp          , Gs          , Gs          , Gs^Ft       , Gs^Gvs      , Gs^Gvs      , Gs^Gvs      , Gs^Gvs      , Gs          , Gs          , Gs          , Gs          , Gs          , Gs^Eff      , Gs^Eff      , Gs^Ft       , Gs^Ft       , Gs^Ft       , Gs^Ft       , Gs^Ft       , Hh^Ft       , Hh^Ft       , Mm          , Mm          , Mm          , Mm          
Ww^Ft       , Ww^Ftp      , Gs          , Gg^Fet      , Ch          , Ch          , Gs          , Rp          , Rp          , Gs^Ft       , Gs^Gvs      , Gs^Gvs      , Gs          , Gs          , Gs          , Gs          , Gs          , Gs          , Gs^Vht      , Gs^Ft       , Gs          , Gs^Eff      , Gs^Eff      , Gs^Eff      , Dd^Vdt      , Hh^Ft       , Mm          , Mm          , Mm          , Mm          , Mm          , Mm          
Ww^Ft       , Ww^Ft       , Gs^Ft       , Dd^Ftd      , Dd^Ftd      , Dd          , Dd          , Dd          , Gs^Ft       , Gs^Ft       , Rp^Vht      , Gs          , Re          , Re          , Re          , Gs          , Gs^Ft       , Gs^Ft       , Gs          , Gs^Ft       , Gs^Ft       , Gs          , Gs          , Dd          , Hd          , Mm          , Mm          , Mm          , Ww          , Wwf         , Hh          , Hh          
Ww^Ft       , Ww^Ftp      , Dd^Ftp      , Dd          , Dd^Ft       , Dd^Ft       , Dd          , Dd          , Rd          , Dd          , Gs^Ft       , Rp          , Hd          , Hd          , Gs^Ft       , Re          , Rd          , Gs^Ft       , Gs          , Gs          , Gs^Ft       , Gs^Ft       , Wo          , Dd          , Wo          , Mm          , Wo          , Wo          , Hh          , Hh          , Hh          , Hh          
Ww^Ft       , Ww^Ft       , Dd^Vda      , Dd          , Dd          , Dd          , Dd          , Rd          , Dd          , Dd          , Dd          , Gs          , Hd          , Hd^Ft       , Hd^Ft       , Dd          , Dd          , Rd          , Re          , Gs          , Wwf         , Wo          , Gs^Ft       , Wo          , Wo          , Wo          , Hh^Ft       , Hh^Ft       , Hh          , Hh          , Hh^Ft       , Hh^Ft       
Ww          , Ww^Ft       , Ww^Ftd      , Dd          , Dd          , Dd          , Rd          , Rd          , Dd          , Dd          , Dd          , Dd          , Hd          , Hd          , Hd^Ft       , Dd          , Dd          , Dd^Ft       , Gs^Ft       , Re          , Ww          , Mm          , Mm          , Dd          , Gs^Ft       , Wo          , Wo          , Hh^Ft       , Hh          , Hh          , Gs          , Gs          
Ww          , Ww^Ftd      , Ww          , Ww          , Wwr         , Dd          , Dd          , Dd          , Dd          , Dd          , Ww          , Wwr         , Wwr         , Wwf         , Hd          , Hd          , Hd          , Dd          , Ww          , Ww          , Ww          , Gs^Vct      , Mm          , Mm          , Mm          , Wwf         , Wo          , Wo          , Hh^Ft       , Hh          , Wo          , Wo          
Ww          , Ww          , Ww          , Ww          , Wwr         , Wwr         , Wwr         , Ww          , Ww          , Ww          , Ww          , Ww          , Dd^Ft       , Hd          , Hd^Ft       , Hd          , Ww          , Ww          , Gs^Ft       , Ww          , Ww^Ft       , Wwf         , Wo          , Mm          , Gs          , Mm^Xm       , Mm          , Wo          , Wo          , Wo          , Mm          , Mm          
Ww          , Ww          , Ww          , Ww          , Ww          , Wwr         , Wwr         , Ww          , Ds          , Ww          , Ds          , Dd          , Dd          , Hd          , Wwf         , Wwf         , Dd^Ft       , Dd^Ft       , Dd^Ft       , Gs^Ft       , Gs          , Gs^Ft       , Gs          , Wo          , Wo          , Mm          , Mm^Xm       , Mm          , Mm          , Mm          , Mm          , Mm          
Ww          , Ww          , Ww          , Ww          , Ds          , Wwr         , Ds          , Ds          , Ds          , Ds          , Ds          , Ds          , Dd          , Wwr         , Hd          , Dd          , Rd          , Dd^Vda      , Dd          , Dd^Ft       , Dd          , Gs^Ft       , Mm          , Mm          , Mm          , Wo          , Mm^Xm       , Mm          , Mm^Xm       , Mm          , Mm          , Hh          
Ww          , Ww          , Ww          , Ww          , Ds          , Ds          , Rd          , Ds          , Ds          , Ds          , Ds          , Dd          , Ww          , Ww          , Dd          , Dd          , Rd          , Dd          , Dd          , Dd          , Mm          , Mm          , Mm          , Mm          , Mm          , Wo          , Wo          , Mm^Xm       , Mm^Xm       , Mm          , Mm^Xm       , Mm          
Ww          , Ww          , Ww          , Ww          , Ds          , Ds          , Ds          , Ds          , Ds          , Ds          , Ww          , Ww          , Ww          , Dd          , Dd          , Dd          , Rd          , Dd          , Dd^Esd      , Mm          , Md          , Mm          , Mm^Xm       , Mm^Xm       , Mm^Xm       , Mm          , Mm          , Wwf         , Mm          , Mm^Xm       , Mm          , Mm^Xm       
Ww          , Ww          , Ww          , Ww          , Ds          , Ds          , Wwr         , Wwr         , Ww          , Ww          , Ww          , Ww          , Dd          , Dd          , Rd          , Rd          , Dd          , Dd          , Md          , Md          , Md          , Md          , Mm          , Wo          , Mm          , Mm^Xm       , Mm^Xm       , Mm          , Mm          , Mm          , Wwf         , Mm^Xm       
Ww          , Ww          , Ww          , Ww          , Ds          , Wwr         , Wwr         , Wwr         , Wwr         , Ww          , Dd          , Dd          , Rd          , Rd          , Dd          , Dd          , Md          , Md          , Md          , Md          , Md          , Md          , Mm          , Wwf         , Wo          , Mm          , Mm          , Mm^Xm       , Mm          , Mm          , Wo          , Mm          
Wo          , Ww          , Ww          , Ww          , Ww          , Ww          , Ww          , Ww          , Dd          , Dd          , Dd          , Rd          , Dd^Esd      , Dd          , Md          , Md          , Md          , Md          , Md          , Md          , Mm          , Mm          , Mm          , Wo          , Mm          , Mm          , Mm          , Mm^Xm       , Mm^Xm       , Mm          , Mm          , Wo          
Wo          , Ww          , Ww          , Ww          , Ww          , Ww          , Dd          , Dd          , Rd          , Dd          , Dd          , Rd          , Dd^Esd      , Md          , Md          , Md          , Md          , Md          , Md          , Md          , Mm          , Mm          , Mm          , Mm          , Mm^Xm       , Mm          , Mm          , Mm          , Mm          , Mm          , Mm          , Wo          
Wo          , Ww          , Ww          , Ww          , Ww          , Ww          , Ww          , Dd          , Dd          , Rd          , Dd          , Rd          , Hd^Esd      , Md          , Md          , Md          , Mm          , Md          , Md          , Md          , Mm          , Mm          , Mm          , Mm          , Mm^Xm       , Mm          , Mm          , Wo          , Wo          , Mm          , Mm          , Mm          
Wo          , Wo          , Wo          , Ww          , Ww          , Ww          , Ww          , Dd          , Dd          , Dd          , Dd          , Dd^Dc       , Dd^Edpp     , Md          , Md          , Md          , Md          , Md          , Md          , Md          , Mm          , Mm          , 2 Mm        , Mm          , Mm^Xm       , Mm          , Mm          , Wo          , Mm          , Mm          , Mm          , Mm          
Wo          , Wo          , Wo          , Ww          , Ww          , Ww          , Ww          , Ww          , Ww          , Dd          , Dd          , Rd          , Hd          , Md          , Md          , Md          , Md^Xm       , Md          , Md          , Md          , Mm          , Mm          , Mm^Xm       , Mm^Xm       , Mm^Xm       , Mm          , Mm          , Mm          , Mm          , Mm          , Mm          , Mm          
Wo          , Wo          , Wo          , Ww          , Ww          , Ww          , Ww          , Ww          , Ww          , Ww          , Dd          , Rd          , Hd          , Hd^Esd      , Hd^Esd      , Md^Xm       , Md^Xm       , Md^Xm       , Md^Xm       , Md          , Mm          , Mm          , Mm          , Mm          , Mm          , Mm^Xm       , Mm^Xm       , Mm          , Mm          , Mm          , Mm          , Mm^Xm       
Wo          , Wo          , Wo          , Wo          , Wwt         , Ww          , Ww          , Ww          , Ww          , Ww          , Ww          , Dd          , Dd          , Hd          , Hd          , Hd^Esd      , Hd^Edpp     , Md^Xm       , Md^Xm       , Md          , Mm          , Mm          , Mm          , Mm          , Mm          , Mm          , Mm^Xm       , Mm^Xm       , Wo          , Mm          , Mm          , Mm          
Wo          , Wo          , Wo          , Wo          , Wot         , Wwt         , Wwt         , Ww          , Ww          , Ww          , Ww          , Dd          , Rd          , Dd          , Hd          , Hd^Edpp     , Md          , Md^Xm       , Md          , Mm          , Mm          , Mm          , Mm          , Mm          , Mm          , Mm^Xm       , Mm          , Hh          , Wo          , Wo          , Wo          , Mm          
