border_size=1
usage=map

Ss          , Ss          , Ss          , Ww          , Gg          , Gg          , Gg          , Gg          , Gg^Efm      , Wo          , Gs^Ft       , Gg          , Gg          , Hh^Ft       , Hh^Ft       , Ww          , Ww          , Gs^Fp       , Ds          , Ds          , Hd          , Hd          , Hd          , Hd          , Hd          , Hd          , Ds          , Ww          , Ww          , Ww          , Ww          , Wo          
Ww          , Ss^Vhs      , Ww^Bw\      , Ww          , Gg          , Gg^Efm      , Gg          , Gg          , Gg          , Wo          , Ss          , Gg          , Gs^Ft       , Hh^Ft       , Hh^Ft       , Dd          , Mm          , Hh          , Gs^Fp       , Hh^Fdw      , Hd          , Ds          , Hd          , Hd          , Hd          , Hd          , Hd          , Ds          , Ds          , Ww          , Ww          , Ww          
Hh          , Ww          , Gs^Ft       , Gg          , Gg^Gvs      , Gg^Gvs      , Gg^Gvs      , Gg^Gvs      , Wo          , Wo          , Ss          , Gs^Ft       , Gg          , Hh^Ft       , Hh^Ft       , Hh          , Mm^Xm       , Hh          , Gg          , Hh^Fp       , Hh^Fp       , Hh          , Ds          , Ds          , Hd          , Hd          , Hd          , Ds          , Ds          , Ds          , Ww          , Ww          
Hh          , Hh^Ft       , Hh^Ft       , Gs^Ft       , Gg          , Gg^Gvs      , Gg          , Gg          , Wo          , Wo          , Wo          , Ss          , Ss          , Gg^Vht      , Hh^Ft       , Hh          , Mm^Xm       , Mm          , Hh^Fp       , Hh^Fp       , Hh^Fp       , Gs^Fp       , Gg          , Ds          , Ds          , Hd          , Dd^Vda      , Hd          , Ds          , Ds          , Ds          , Ww          
Mm          , Hh          , Hh          , Hh^Ft       , Gg          , Gg          , Wo          , Wo^Bw\      , Ch          , Ch          , Chs         , Wwr         , Gs^Ft       , Gs^Ft       , Hh          , Hh          , Wo          , Gs^Fp       , Ss          , Hh          , Hh^Fp       , Gs^Fp       , Gg          , Gg          , Rd          , Rd          , Ds          , Hd          , Hd          , Ds          , Ds          , Ds          
Mm          , Mm          , Hh          , Hh^Ft       , Hh          , Wo          , Gg          , Wo          , Ch          , 2 Khw       , Chw         , Wo          , Wo          , Ss          , Wo          , Wo          , Wo          , Wo          , Ss          , Ss          , Hh^Fp       , Gs^Fp       , Rd          , Rd          , Gg          , Ds          , Ds          , Hd          , Hd          , Ds          , Ds          , Ww          
Hh          , Hh          , Hh          , Hh          , Wwf         , Wwr         , Gg          , Wo          , Wo          , Wo          , Wo          , Wo          , Hh          , Wo          , Hh          , Wo          , Wo          , Wo          , Wwf         , Gs^Fp       , Gs^Fp       , Re          , Gs^Fp       , Gg          , Gg          , Gg          , Ds          , Ds          , Hd          , Ds          , Ds          , Ds          
Wwf^Bw\     , Ww          , Ww          , Hh          , Ww          , Gg          , Hh          , Gg          , Gg          , Gg          , Gg          , Hh          , Hh^Fp       , Hh          , Wwr         , Wo          , Chs         , Wo          , Wo          , Ss          , Gs^Fp       , Re          , Ww          , Gs^Fp       , Gg          , Gg          , Gg          , Ds          , Ds          , Ds          , Ds          , Ds          
Ww          , Ww^Bw\      , Hh^Vhh      , Wwf^Fp      , Hh          , Hh          , Hh          , Hh          , Gg          , Gg          , Gg          , Gs^Fp       , Gs^Fp       , Ww          , Ww          , Chw         , Khw         , Wwf         , Wwf         , Gg          , Gg^Vh       , Wwf         , Gg          , Ww          , Ww          , Ww          , Ww          , Gg          , Ds          , Ds          , Ds          , Ds          
Wo          , Ww          , Mm          , Hh          , Hh^Fp       , Hh          , Hh          , Hh^Fp       , Hh^Fp       , Gs^Fp       , Gg          , Gg          , Gs^Fp       , Ww          , Ww          , Chw         , Chw         , Wwf         , Ww          , Gg          , Gg          , Wwf         , Re          , Gg          , Gg          , Gs^Fp       , Gg^Ve       , Ww          , Ds          , Ds          , Ds          , Ds          
Wo          , Ww          , Mm          , Mm          , Ww^Fp       , Hh          , Hh          , Hh          , Hh          , Hh^Fp       , Gs^Fp       , Gg          , Gg          , Ww          , Ww          , Ww          , Ww          , Ww          , Gg          , Gg          , Ww          , Ww          , Gg          , Rd          , Rd          , Gg^Efm      , Gs^Fp       , Ww          , Ww          , Ds          , Ds          , Ds          
Ww          , Ww          , Wwf^Ft      , Ww          , Ww          , Ww          , Hh          , Hh          , Hh          , Hh^Fp       , Gs^Fp       , Gg          , Gg          , Gg          , Gg          , Gg          , Gg          , Ww          , Gg          , Gg          , Ww          , Ww          , Gg          , Gs^Fp       , Gg          , Rd          , Rd          , Gs^Fp       , Gs^Fp       , Ww          , Ww          , Ww          
Hh^Ft       , Mm^Ft       , Mm^Ft       , Wwf^Ft      , Ww          , Ww          , Ww          , Hh          , Ww          , Hh          , Hh^Efm      , Gg^Efm      , Gg          , Gg          , Gg          , Gg          , Gg          , Gg          , Gg          , Ww          , Gg          , Gs^Fp       , Gs^Fp       , Gs^Fp       , Gs^Fp       , Gs^Fp       , Rd          , Gs^Fp       , Gg          , Ds          , Ww          , Ds          
Mm          , Mm          , Mm^Ft       , Wwf         , Ww          , Ww          , Ww          , Ww          , Ww          , Hh^Ve       , Hh          , Hh^Efm      , Gg          , Gg          , Gg          , Gg          , Gg          , Gg          , Gs^Fp       , Ww          , Gs^Fp       , Gs^Fp       , Gs^Fp       , Gs^Fp       , Gs^Fp       , Gs^Fp       , Rd          , Gg          , Gg          , Gg          , Ww          , Ww          
Mm          , Mm          , Mm          , Wwf         , Wwf         , Wwf         , Ww          , Ww          , Hh^Fp       , Hh^Fp       , Hh          , Hh          , Gg          , Gg          , Ww          , Gg          , Gg          , Gg          , Ww          , Ww          , Gs^Fp       , Gg          , Gs^Fp       , Gs^Fp       , Gs^Fp       , Gs^Fp       , Co          , Gs^Fp       , Re          , Re          , Ds          , Ww          
Mm          , Mm          , Mm          , Mm          , Wwf         , Ww          , Ww          , Ww          , Ww          , Hh^Fp       , Hh          , Hh          , Ww          , Ww          , Ww          , Ww          , Ww^Es       , Wwf         , Rr          , Ww^Es       , Gg          , Gg          , Gs^Fp       , Gs^Fp       , Gs^Fp       , Co          , Ko          , Co          , Gg          , Gg          , Ds          , Ww          
Mm          , Mm          , Wwf         , Mm          , Wwf         , Ww          , Ww          , Mm          , Ww          , Ww          , Ww          , Ww          , Ww          , Ww          , Gg          , Ww          , Gg^Vh       , Rr          , Gs^Fp       , Rd          , Gs^Fp       , Gs^Fp       , Gs^Fp       , Gs^Fp       , Gs^Fp       , Co          , Rd          , Co          , Gg          , Gg          , Ds          , Ds          
Mm          , Wwf         , Mm^Vhh      , Wwf         , Mm          , Mm          , Ww^Es       , Ww          , Mm          , Hh          , Hh          , Hh          , Hh          , Gg          , Gg^Efm      , Gg          , Gg          , Gg^Efm      , Gs^Fp       , Rd          , Gs^Fp       , Gs^Fp       , Gs^Fp       , Gs^Fp       , Rd          , Rd          , Gg          , Gg          , Gg          , Dd          , Ds          , Ds          
Wo^Fts      , Wwf         , Mm          , Mm          , Mm          , Mm          , Mm          , Mm          , Mm          , Mm          , Hh          , Hh          , Hh          , Gg^Efm      , Gg^Gvs      , Gg^Gvs      , Gg^Gvs      , Gg          , Gs^Fp       , Rd          , Rd          , Gg          , Rd          , Rd          , Gs^Fp       , Gg          , Gg^Vh       , Gg          , Gg          , Gg          , Gg          , Ds          
Mm^Ftr      , Mm          , Mm          , Mm          , Mm          , Mm          , Mm          , Mm          , Mm          , Mm          , Hh          , Hh          , Hh          , Gg^Gvs      , Gg^Gvs      , Gg^Gvs      , Gg^Gvs      , Gg          , Gs^Fp       , Gs^Fp       , Gs^Fp       , Rd          , Rd          , Gs^Fp       , Gs^Fp       , Gg          , Gg          , Gg^Efm      , Gg          , Gg          , Gg          , Ds          
Mm^Ftr      , Mm          , Mm          , Mm          , Ww          , Mm          , Mm          , Mm          , Mm          , Mm          , Hh          , Hh          , Hh          , Gg^Gvs      , Gg^Gvs      , Gg^Gvs      , Gg^Gvs      , Gg          , Gs^Fp       , Gs^Fp       , Gs^Fp       , Gs^Fp       , Gs^Fp       , Rd          , Rd          , Gs^Fp       , Gg          , Gg          , Gg          , Gg          , Ds          , Ds          
Mm          , Mm          , Mm          , Mm          , Wo          , Wo          , Wo          , Mm          , Mm          , Mm          , Hh          , Hh          , Hh          , Hh          , Gg^Gvs      , Gg^Gvs      , Gg^Gvs      , Gg          , Gg          , Gs^Fp       , Gg          , Gs^Fp       , Gg          , Gs^Fp       , Rd          , Gg          , Gg          , Gg          , Gg          , Gg          , Ds          , Ds          
Wwf         , Wo          , Wo          , Wo          , Wo          , Mm          , Mm          , Wo          , Mm          , Mm          , Hh          , Hh          , Hh          , Hh          , Gg^Gvs      , Gg^Gvs      , Gg          , Gg          , Gg          , Gg          , Gg          , Gg          , Gg          , Gg          , Gg          , Rd          , Rd          , Gg          , Gg          , Gg          , Ds          , Ds          
Mm          , Wo          , Wo          , Wo          , Mm          , Mm          , Mm          , Wo          , Mm          , Mm          , Hh          , Hh          , Wo          , Hh          , Gg          , Gg          , Ww          , Gg          , Wo          , Wo          , Wo          , Wo          , Wo          , Wo          , Wo          , Gs^Fds      , Gs^Fds      , Rd          , Gg          , Gg          , Ds          , Ds          
Mm          , Mm          , Mm          , Mm          , Mm          , Mm          , Mm          , Wo          , Mm^Xm       , Ww          , Wo          , Wo          , Wo          , Gs^Fp       , Wo          , Gg^Efm      , Wo          , Wo          , Wwf         , Wo          , Gg          , Gg          , Gs^Fp       , Gs^Fp       , Wo          , Ss          , Gs^Fds      , Rd          , Rd          , Gg          , Ds          , Ds          
Mm          , Mm          , Mm          , Mm          , Mm          , Mm          , Mm          , Wo          , Wo          , Wo          , Hh          , Hh^Vhh      , Ww          , Wo          , Gs^Fp       , Wo          , Gs^Fp       , Gs^Fp       , Gg          , Gg^Vh       , Re          , Gg          , Gs^Fp       , Gg          , Gg          , Wo          , Gs^Fds      , Gs^Fds      , Rd          , Gs^Ft       , Gs^Ft       , Ds          
Mm^Xm       , Mm^Xm       , Mm^Xm       , Mm          , Mm          , Mm          , Mm          , Mm          , Mm          , Mm          , Hh          , Hh          , Hh          , Gs^Fp       , Gs^Fp       , Gs^Fp       , Gg^Efm      , Gg^Efm      , Gg          , Re          , Re          , Gg          , Gg          , Gg          , Ss          , Wo          , Ss          , Gs^Ft       , Rd          , Gs^Ft       , Gs^Ft       , Ds          
Wwf^Es      , Mm          , Mm          , Mm          , Mm          , Mm          , Mm          , Mm          , Mm          , Mm          , Hh          , Hh          , Hh          , Gs^Fp       , Gs^Fp       , Gg^Efm      , Gg^Efm      , Gg          , Gg          , Gg          , Re          , Gg^Efm      , Gg          , Gg          , Ss          , Wo          , Wo          , Gs^Ft       , Rd          , Gs^Ft       , Gs^Ft       , Ds          
Mm          , Wwf^Es      , Mm^Vhh      , Mm          , Ww          , Mm          , Mm          , Mm          , Mm          , Mm          , Hh          , Hh          , Hh^Fp       , Gs^Fp       , Gs^Fp       , Gs^Fp       , Re^Gvs      , Re^Gvs      , Re^Gvs      , Gg          , Re          , Gg          , Gg          , Gg          , Ss          , Ss          , Wo          , Rd          , Gs^Ft       , Gs^Ft       , Wo          , Wo          
Re          , Wwf^Bh/     , Ww          , Ww          , Ww          , Ww          , Ww          , Mm          , Mm          , Hh          , Hh          , Hh^Fp       , Hh^Fp       , Gs^Fp       , Gg^Vl       , Re^Gvs      , Re^Gvs      , Re^Gvs      , Re          , Re          , Gg^Efm      , Gs^Fp       , Gg          , Ss          , Ss          , Ss          , Wo          , Wwf         , Wo          , Wo          , Ds          , Wo          
Re          , Mm          , Mm          , Ww          , Ww          , Mm          , Ww          , Mm          , Mm          , Hh          , Hh          , Hh^Fp       , Gs^Fp       , Gs^Fp       , Gg          , Gg^Efm      , Re          , Re          , Gg          , Gg          , Gs^Fp       , Gs^Fp       , Gg          , Gg          , Ss          , Gs^Fp       , Gg          , Wo          , Wo          , Wo          , Ds          , Ww          
Mm          , Mm          , Mm          , Ww          , Mm          , Mm          , Ww          , Mm          , Mm          , Hh          , Hh          , Hh          , Ww          , Wwf         , Wwf         , Re          , Gg          , Gg          , Gs^Fp       , Gs^Fp       , Gs^Fp       , Gs^Fp       , Ss          , Ss          , Gs^Fp       , Gs^Fp       , Wo          , Wo          , Ds          , Ds          , Ds          , Ww          
Re          , Mm          , Mm          , Mm          , Mm          , Mm          , Ww          , Mm          , Mm          , Hh          , Ww          , Ww          , Ww          , Gg          , Ww          , Gg          , Ww          , Gg          , Gg          , Gs^Fp       , Gs^Fp       , Gg          , Ss          , Gs^Fp       , Gg          , Gg          , Wo          , Gs^Ft       , Dd^Vdt      , Ds          , Ww          , Ww          
Mm          , Re          , Mm          , Mm          , Mm          , Mm          , Mm          , Ww          , Ww          , Ww          , Hh          , Ww          , Gg^Vh       , Gg          , Ww          , Ww          , Ww          , Ww          , Gg          , Gs^Fp       , Gg          , Gs^Fp       , Gs^Fp       , Gg          , Gg          , Wo          , Gs^Ft       , Gs^Ft       , Ds          , Ds          , Ww          , Ww          
Mm          , Re          , Mm          , Mm          , Mm          , Mm          , Mm          , Mm          , Hh          , Ww          , Hh          , Gg          , Gg          , Gg          , Wwf         , Ww          , Gg^Efm      , Ww          , Gg^Vh       , Gs^Fp       , Gs^Fp       , Ss          , Gs^Fp       , Gs^Fp       , Ce          , Wo          , Gs^Ft       , Ds          , Ds          , Ds          , Ds          , Ww          
Mm          , Re          , Re          , Mm          , Mm          , Mm          , Mm          , Mm          , Hh          , Hh          , Gg          , Gg          , Ss          , Wwf         , Gg          , Gg          , Gg          , Wwf         , Ww          , Ww          , Gs^Fp       , Gs^Fp       , Ss          , 1 Ke        , Ce          , Wo          , Ds          , Ds          , Ds          , Ds          , Ds          , Ds          
Mm          , Mm          , Re          , Mm          , Mm          , Mm          , Mm          , Wwf         , Hh          , Hh          , Gg          , Ss          , 3 Ss^Vm     , Ww          , Gg          , Re^Gvs      , Re^Gvs      , Gg          , Gg          , Ww          , Ww          , Gg          , Ww          , Re          , Gg          , Wo          , Ds          , Ds          , Ds          , Ds          , Ww          , Ww          
Mm          , Mm          , Mm          , Re          , Re          , Mm          , Mm          , Ww^Ewl      , Ww          , Gg          , Ww          , Ww^Ewf      , Ww          , Ww          , Gg          , Re^Gvs      , Re^Gvs      , Re^Gvs      , Gg^Efm      , Ww          , Gg^Efm      , Ww          , Ww          , Wwf         , Ww          , Wo          , Ds          , Ds          , Ww          , Ww          , Wwr         , Wwr         
Mm          , Mm          , Mm          , Mm          , Re          , Mm^Vhh      , Hh          , Hh^Fp       , Hh^Fp       , Ww          , Ss          , Ss          , Ss          , Ss          , Gg          , Re^Gvs      , Re^Gvs      , Re^Gvs      , Re^Gvs      , Gg^Efm      , Gg^Efm      , Ww          , Gg          , Re          , Ss          , Wo          , Wo          , Wo          , Wo          , Wwr         , Wo          , Wwr         
Mm          , Mm          , Mm          , Mm          , Mm          , Re          , Hh          , Hh^Fp       , Gg          , Hh^Fp       , Ss          , Ss          , Ss          , Ss          , Ss          , Re^Gvs      , Re^Gvs      , Re^Gvs      , Re^Gvs      , Re^Gvs      , Gg          , Gg          , Re          , Re          , Ss          , Ss          , Ss          , Ss          , Ss          , Wo          , Wo          , Wo          
Mm          , Mm^Xm       , Mm^Xm       , Mm          , Re          , Re          , Re          , Gg          , Gg          , Gg^Efm      , Gg^Efm      , Gg^Efm      , Gg          , Ss          , Ss          , Gg          , Re^Gvs      , Re^Gvs      , Gg^Efm      , Gg          , Re          , Re          , Ss          , Ss          , Ss          , Ss          , Ss          , Ss^Vm       , Ww          , Wo          , Wo          , Wo          
Wo          , Mm^Xm       , Mm          , Mm          , Re          , Hh          , Hh          , Re          , Re          , Gg          , Gg          , Gg^Efm      , Ss          , Ss          , Ss          , Gg          , Gg          , Re^Gvs      , Gg^Efm      , Gg          , Re          , Ss          , Ss          , Ss          , Ss          , Ss          , Ss          , Ww          , Wo          , Wo          , Wo          , Wo          
