border_size=1
usage=map

Wo          , Wo          , Wo          , Wo          , Wo          , Wo          , Wwr         , Wo          , Wo          , Wo          , Wo          , Wo          , Wo          , Wo          , Wo          , Wo          , Wo          , Wo          , Wo          , Wo          , Wo          , Wo          , Wo          , Wo          , Wo          , Wo          , Wo          , Wo          , Wo          , Wo          , Wo          , Wo          , Wo          , Wo          
Wo          , Wo          , Wo          , Wo          , Wwr         , Wwr         , Wwr         , Wwr         , Wwr         , Wwr         , Wo          , Wo          , Wo          , Wo          , Wo          , Wo          , Wo          , Wo          , Wo          , Wo          , Wo          , Wo          , Wo          , Wo          , Wo          , Wo          , Wo          , Wo          , Wo          , Wo          , Wo          , Wo          , Wo          , Wo          
Wo          , Wo          , Wo          , Wwr         , Wwr         , Wwr         , Wwr         , Wwr         , Wwr         , Wo          , Wo          , Wo          , Wo          , Wo          , Wo          , Wo          , Wo          , Wo          , Wo          , Wo          , Wo          , Wo          , Wo          , Wo          , Wo          , Wo          , Wo          , Wo          , Md^Xm       , Wo          , Md^Xm       , Ds          , Ds          , Wo          
Wo          , Wo          , Wo          , Wwr         , Wwr         , Wwr         , Wwr         , Wwr         , Wo          , Wo          , Wo          , Wo          , Wo          , Wo          , Wo          , Wo          , Wo          , Wo          , Wo          , Wo          , Wo          , Wo          , Wo          , Wo          , Wo          , Wo          , Wo^Ft       , Md^Xm       , Md^Xm       , Ww          , Md^Xm       , Ds          , Ds          , Ww          
Wo          , Wo          , Wo          , Wo          , Wo          , Wo          , Wo          , Wo          , Wo          , Wo          , Wo          , Wo          , Wo          , Wo          , Wo          , Wo          , Wo          , Wo          , Wo          , Wo          , Wo          , Wo          , Wo          , Wo          , Wo          , Wo          , Wo^Ft       , Dd^Do       , Dd          , Md^Xm       , Ds          , Ds          , Ww          , Ww          
Wo          , Wo          , Wo          , Wo          , Wo          , Wo          , Wo          , Wo          , Wo          , Wo          , Wo          , Wo          , Wo          , Wo          , Wo          , Wo          , Wo          , Wo          , Wo          , Wo          , Wo          , Wo          , Wo          , Wo          , Wo          , Wo          , Wo          , Wo^Ft       , Ww          , Ds          , Ww          , Ww          , Ww          , Ww          
Wo          , Wo          , Wo          , Wo          , Wo          , Wo          , Ww          , Wo          , Wo          , Wo          , Wo          , Wo          , Wo          , Wo          , Wo          , Wo          , Wo          , Wo          , Wwr         , Wo          , Wwr         , Wo          , Wo          , Wo          , Wo          , Wo          , Wo          , Wo          , Ww          , Ww          , Wo          , Wo          , Wo          , Wo          
Wo          , Wo          , Wo          , Wo          , Ds          , Ds          , Ds          , Wwr         , Wwr         , Wo          , Wo          , Wo          , Wo          , Wo          , Wo          , Wo          , Wo          , Wo          , Wwr         , Wwr         , Ww          , Ww          , Wo          , Wo          , Wo          , Wo          , Ww          , Ww          , Wo          , Wo          , Wo          , Wo          , Wo          , Wo          
Wo          , Wo          , Wo          , Wo          , Ds          , Hd^Ft       , Hd^Ft       , Ds          , Wwr         , Wwr         , Wwr         , Wo          , Wo          , Wo          , Wo          , Wo          , Wo          , Wo          , Wwr         , Ww          , Ww          , Ww          , Ww          , Wo          , Wo          , Wo          , Ww          , Ww          , Wo          , Wo          , Wo          , Wo          , Wo          , Wo          
Wo          , Wo          , Wo          , Ds          , Hd^Ft       , Hd^Ft       , Dd^Do       , Ds          , Wwr         , Wwr         , Wwr         , Wo          , Wo          , Wo          , Wo          , Wo          , Wo          , Wo          , Wo          , Wwr         , Wo          , Ww          , Ww          , Ww          , Ww          , Ww          , Ww          , Ww          , Wo          , Wo          , Wo          , Wo          , Wo          , Wo          
Wo          , Wo          , Wo          , Ds          , Ds          , Hd^Ft       , Hd^Ft       , Hd^Ft       , Ds          , Wwr         , Wwr         , Wo          , Wo          , Wo          , Wo          , Wo          , Wo          , Wo          , Wo          , Wo          , Wo          , Wo          , Wo          , Ww          , Ww          , Ww          , Ww          , Ww          , Ww          , Wo          , Wo          , Wo          , Wo          , Wo          
Wo          , Wo          , Wo          , Wo          , Ds^Ft       , Ds^Ft       , Hd^Ft       , Hd          , Ds          , Wwr         , Wwr         , Wo          , Wo          , Wo          , Wo          , Wo          , Wo          , Wo          , Wo          , Wo          , Wo          , Wo          , Wo          , Wo          , Ww          , Ww          , Ww          , Ww          , Ds          , Ds          , Ds          , Ds          , Ds          , Ds          
Wo          , Wo          , Wo          , Ds^Ft       , Hd^Ft       , Hd^Ft       , Hd^Ft       , Hd          , Ds^Ft       , Ds          , Wwr         , Wo          , Wo          , Wo          , Wo          , Wo          , Wo          , Wo          , Wo          , Wo          , Wo          , Wo          , Wo          , Ww          , Ww          , Ww          , Ww          , Dd          , Gs          , Gs          , Hd          , Hd          , Md          , Md          
Wo          , Wo          , Wo          , Wo          , Hd^Ft       , Hd^Ft       , Hd^Ft       , Hd^Ft       , Ds^Ft       , Ds          , Ww          , Wo          , Wo          , Wo          , Wo          , Wo          , Wo          , Wo          , Wo          , Wo          , Wo          , Wo          , Wo          , Ww          , Ww          , Dd          , Ww          , Gs          , Gs          , Gs          , Hd          , Md          , Md          , Md          
Wo          , Wo          , Wwr         , Wwr         , Hd          , Hd^Ft       , Hd^Ft       , Hd^Ft       , Ds^Ft       , Dd          , Ds          , Wo          , Wo          , Wo          , Wo          , Wo          , Wo          , Wo          , Wo          , Wo          , Wo          , Wo          , Ww          , Ww^Vm       , Ww          , Gs          , Ss          , Gs          , Gs          , Gs          , Hd          , Hd^Es       , Md          , Md          
Wo          , Wo          , Wwr         , Hd^Ftp      , Hd          , Hd          , Ww^Ft       , Dd^Do       , Dd^Vdt      , Dd          , Ds          , Ds          , Ds^Ft       , Wo          , Wo          , Wo          , Wo          , Wo          , Wo          , Wo          , Wo          , Ww          , Ww          , Ww          , Ww          , Gs          , Ss          , Gs          , Gs          , Gs          , Hd          , Md          , Ww^Ewf      , Ww          
Wo^Ftp      , Wo          , Wwr         , Hd^Ftp      , Dd^Do       , Dd          , Wo          , Ww          , Ww          , Dd          , Ds^Ft       , Ds^Ft       , Ds^Ft       , Ds^Ft       , Wo          , Wo          , Wo          , Wo          , Wo          , Wo          , Wo          , Ww          , Ww          , Ww          , Dd          , Ww^Ftd      , Dd          , Ww          , Gs          , Hd          , Hd          , Hd          , Md          , Ww          
Wo          , Wo^Ftp      , Ds^Ft       , Ds^Ft       , Ds          , Ww          , Ww          , Wo          , Ds          , Ds^Ft       , Ds^Ft       , Ds^Ft       , Ds^Ft       , Ds^Ft       , Wo          , Wo          , Wo          , Wo          , Wo          , Wo          , Ww          , Ww          , Ww          , Dd          , Dd          , Dd          , Ww^Es       , Ww          , Gs^Ft       , Hd          , Hd          , Hd          , Ww          , Ww          
Wo          , Wo          , Dd^Do       , Ds^Ft       , Ds^Ft       , Ds          , Ww          , Wo          , Ds          , Ds          , Ds^Ft       , Ds^Ft       , Wwr         , Wwr         , Wo          , Wo          , Wo          , Wo          , Wo          , Ww          , Ww          , Ww          , Dd          , Gs          , Gs^Ft       , Dd          , Ww^Es       , Dd          , Gs^Ft       , Gs          , Hd          , Hd          , Ww          , Ww          
Wo          , Wo          , Ds^Vct      , Ds^Ft       , Ds^Es       , Chw^Ft      , Wwf^Ftp     , Wo          , Wo          , Ds          , Wo          , Wwr         , Wwr^Ft      , Wwr^Ftd     , Wwr         , Ww^Vm       , Ww          , Wo          , Ww          , Ww          , Ww          , Dd          , Gs          , Gs          , Gs^Ft       , Dd^Vdt      , Ww^Es       , Dd          , Gs^Ft       , Gs          , Hd          , Hd          , Hd          , Hd          
Wo          , Wo          , Ww          , Ds^Ftd      , Ds          , Chw         , 2 Khw       , Wwf         , Wo          , Wo          , Wo          , Ww^Ft       , Wwr^Ftd     , Wwr^Ftd     , Wwr         , Wwr         , Ww          , Ww          , Ww          , Ww          , Ww          , Gg^Vh       , Gs          , Gs          , Gs          , Gs^Ft       , Ww          , Dd^Do       , Ww          , Ww          , Ww          , Hd          , Hd          , Hd          
Wo          , Wo          , Ds          , Ds^Ftd      , Ds          , Chw         , Chw         , Wwf^Es      , Wo          , Wo          , Ww^Ftd      , Dd^Do       , Wwr^Ftd     , Wwr^Ftd     , Wwr         , Ww          , Ww          , Ww          , Ww          , Ww          , Dd          , Gs^Ft       , Gs          , Gs          , Gs          , Gs          , Ww          , Ww          , Gg^Vh       , Ww          , Ww          , Hd          , Hd          , Hd          
Wo          , Wo          , Ds          , Ds          , Ds          , Ds          , Wo          , Wo          , Wo          , Wo          , Wo          , Ww^Ftd      , Ww^Ftd      , Ww^Ftd      , Wwr         , Ww          , Ww          , Ww          , Ww          , Dd          , Dd          , Dd          , Rd          , Gs^Ft       , Gs          , Ww          , Ww          , Ww^Ewf      , Gs          , Gs          , Ww          , Hd          , Hd          , Ww          
Wo          , Wo          , Wo          , Ds          , Ds          , Ww          , Wo          , Wo          , Wo          , Wo          , Wo          , Ww          , Ww          , Ww          , Ww          , Ww          , Dd          , Dd          , Dd          , Dd^Ecf      , Dd          , Dd          , Rd          , Dd          , Dd          , Ww          , Ww          , Gs          , Gs          , Gs          , Ww          , Ww          , Ww          , Ww^Bw\      
Wo          , Wo          , Wo          , Ds          , Ds          , Ww          , Ww          , Wo          , Wo          , Wo          , Wo          , Wo          , Ww          , Ww          , Ww^Ft       , Gg^Vh       , Gs          , Dd          , Dd          , Dd          , Rd          , Rd          , Dd          , Dd          , Dd          , Dd          , Gs^Ftp      , Gs          , Gs          , Gs          , Ww          , Ww          , Ww          , Ww          
Wo          , Wo          , Wo          , Ds          , Ds          , Dd^Vda      , Wwr         , Wo          , Wo          , Wo          , Wo          , Wo          , Ww          , Ww^Ft       , Gs^Ft       , Gs          , Gs          , Gs          , Gs^Ft       , Rd          , Gs^Ft       , Hd          , Hd          , Dd          , Hd          , Hd          , Gs^Ftp      , Gs^Ftp      , Gs          , Hd          , Ww          , Hd          , Hd          , Dd^Vdt      
Wo          , Wo          , Wo          , Ds^Ft       , Ds^Ft       , Dd^Do       , Wwr^Ft      , Wwr         , Wo          , Wo          , Ww          , Ww          , Ww          , Dd          , Gs^Ft       , Gs^Ft       , Gs          , Gs          , Gs          , Hd          , Hd          , Hd          , Ww          , Ww          , Hd          , Hd          , Hd          , Gs          , Hd          , Hd          , Ww          , Hd          , Hd          , Hd          
Wo          , Wo          , Wo          , Wo          , Wo          , Ds^Ft       , Wwr^Ft      , Wo          , Wo          , Wo          , Ww          , Ww          , Ww          , Dd          , Gs^Ft       , Gs^Ft       , Gs          , Gs          , Hd          , Hd          , Dd^Vdt      , Hd          , Ww          , Ww          , Ww          , Hd          , Hd          , Hd          , Hd          , Ww          , Hd          , Hd          , Hd          , Hd          
Wo          , Wo          , Wo          , Wo          , Wo          , Wo          , Wo          , Wo          , Wo          , Wo          , Ww          , Ww          , Ww          , Dd          , Dd          , Dd^Vdt      , Gs          , Gs          , Hd          , Ww          , Ww          , Ww          , Ww          , Ww          , Ww          , Ww          , Ww          , Ww          , Ww          , Ww          , Hd          , Hd          , Rd          , Rd          
Wo          , Wo          , Wo          , Wo          , Wo          , Wo          , Wo          , Wo          , Wo          , Wo          , Ww^Vm       , Ww          , Ww          , Dd          , Dd          , Dd          , Rd          , Hd          , Hd          , Md          , Ww          , Ww          , Ww          , Ww          , Ww          , Ww          , Ww          , Hd          , Ww          , Hd          , Rd          , Rd          , Md          , Md          
Wo          , Wo          , Wo          , Wo          , Wo          , Wo          , Wo          , Wo          , Ww          , Ww          , Ww          , Ww          , Ww          , Dd          , Rd          , Rd          , Dd          , Hd          , Md          , Ww          , Ww          , Ww          , Ww          , Ww          , Ww          , Hd          , Hd          , Hd          , Ch          , Rd          , Hd          , Md          , Md          , Md          
Wo          , Wo          , Wo          , Wo          , Wo          , Wo          , Wo          , Wo          , Ww          , Ww          , Ww          , Ww          , Ww          , Dd^Vda      , Rd          , Dd          , Dd          , Ww^Es       , Ww          , Ww          , Ww          , Ww          , Ww          , Ww          , Ww          , Hd          , Hd          , Ch          , Ch          , 3 Kh        , Hd          , Hhd^Vhh     , Md          , Md          
Wo          , Wwr         , Wwr         , Wo          , Wo          , Wo          , Wo          , Wo          , Ww          , Ww          , Ww          , Ww          , Ww          , Dd          , Rd          , Dd          , Dd          , Hd          , Ww          , Ww          , Ww          , Ww          , Ww          , Ww          , Ww          , Hd          , Dd^Vdt      , Ww          , Ww^Bw|      , Ww          , Hd          , Md          , Md          , Md          
Wo          , Wwr         , Wwr         , Wwr         , Wo          , Wo          , Wo          , Wo          , Ww          , Ww          , Ww          , Ww          , Ww          , Dd          , Dd          , Rd          , Dd          , Dd          , Ww          , Ww          , Ww          , Ww          , Ww          , Ww          , Hd          , Ww          , Ww          , Ww          , Rr          , Hd          , Md          , Md          , Md          , Md          
Wo          , Wwr         , Wwr         , Wo          , Wo          , Wo          , Wo          , Wo          , Wo          , Ww          , Ww          , Ww          , Ww          , Dd          , Gs^Ft       , Rd          , Dd          , Gs^Ft       , Ww^Ftp      , Dd^Do       , Ww          , Ww          , Ww          , Hd          , Hd          , Ww          , Hd          , Rr          , Hd          , Hd          , Md          , Md          , Md          , Md          
Wo          , Wwr         , Wwr         , Wo          , Wo          , Wo          , Wo          , Wo          , Wo          , Ww          , Ww          , Ww          , Ww          , Ww          , Dd          , Gs          , Gs^Ft       , Gs          , Gs          , Dd^Vda      , Dd          , Ww          , Dd          , Gs^Ft       , Hd          , Hd          , Hd          , Rr          , Hd          , Hd          , Md          , Md          , Md          , Md          
Wo          , Wo          , Wo          , Wo          , Wo          , Wo          , Wo          , Wo          , Wo          , Wo          , Ww          , Ww          , Ww          , Ww          , Ww          , Gs          , Gs          , Gs^Ft       , Gs^Ft       , Dd          , Dd          , Ww          , Ww          , Dd          , Gs^Ft       , Hd          , Hd          , Rr          , Hd          , Hd          , Hhd         , Md          , Md          , Md          
Wo          , Wo          , Wo          , Wo          , Wo          , Wo          , Wo          , Wo          , Wo          , Wo          , Wo          , Ww          , Ww          , Ww          , Ww          , Ww          , Dd^Vda      , Gs^Ft       , Dd          , Dd          , Dd          , Dd          , Dd          , Ww          , Dd          , Gs^Ft       , Gg^Vh       , Rr          , Gs          , Hd          , Hd          , Md          , Md          , Md          
Wo          , Wo          , Wo          , Wo          , Wo          , Wo          , Wo          , Wo          , Wo          , Wo          , Wo          , Ww          , Ww          , Ww          , Ww          , Ww          , Dd          , Rd          , Rd          , Dd          , Dd          , Dd          , Dd          , Ww          , Dd          , Dd          , Rp          , Rp          , Gs          , Hd          , Hd          , Md          , Md          , Mm          
Wo          , Wo          , Wo          , Wo          , Wo          , Wo          , Wo          , Wo          , Wo          , Wo          , Wo          , Wo          , Wo          , Ww          , Ww          , Ww          , Ww          , Dd          , Dd^Do       , Rd          , Rd          , Dd          , Dd          , Ww          , Dd          , Rr          , Gs^Ft       , Gs          , Gs          , Gs          , Dd^Vc       , Hd          , Mm          , Mm          
Wo          , Wo          , Wwr         , Wwr         , Wo          , Wo          , Wo          , Wo          , Wo          , Wo          , Wo          , Wo          , Wo          , Wo          , Wo          , Ww          , Ww          , Ww          , Ww          , Dd^Ftd      , Dd^Ftd      , Rd          , Rd          , Ww          , Dd          , Rr          , Dd          , Gs          , Gs          , Gs          , Hd^Eff      , Hd^Eff      , Dd^Edpp     , Hh^Ft       
Wo          , Wo          , Wwr         , Wwr         , Wwr         , Wo          , Wo          , Wo          , Wo          , Wo          , Wo          , Wo          , Wo          , Wo          , Wo          , Wo          , Wo          , Ww          , Ww          , Ww          , Ww          , Dd^Ftd      , Ww          , Ww^Bw\      , Rr          , Rr          , Dd          , Gs          , Gs          , Gs          , Dd^Ftd      , Hd^Eff      , Hd^Eff      , Hh^Ft       
Wo          , Wo          , Wo          , Wwr         , Wwr         , Wo          , Wo          , Wo          , Wo          , Wo          , Wo          , Wo          , Wo          , Wo          , Ww          , Ww          , Ww          , Ww          , Ww          , Ww          , Gs^Ftp      , Ww          , Ww          , Dd^Vda      , Rr          , Dd          , Gs          , Gs          , Gs          , Gs          , Gs^Eff      , Dd^Eff      , Hh^Ft       , Hh^Ft       
Wo          , Wo          , Wwr         , Wwr         , Wo          , Wo          , Wo          , Wo          , Wo          , Wo          , Wo          , Wo          , Wo          , Wo          , Ww          , Ww          , Ww          , Ww          , Ww          , Dd          , Gs          , Gs^Ftp      , Gs^Ftp      , Dd          , Rr          , Dd          , Gs          , Gs          , Gs          , Gs^Ft       , Gs^Ft       , Gs^Eff      , Dd^Eff      , Hh^Ft       
Wo          , Wwr         , Wwr         , Wwr         , Wo          , Wo          , Wo          , Wo          , Wo          , Wo          , Wo          , Wo          , Wo          , Ww          , Ww          , Ww          , Ww          , Ww          , Dd          , Gs          , Gs          , Gs          , Rp          , Rr^Vhc      , Rr          , Gs^Ft       , Gs^Vht      , Gs^Ft       , Gs^Ftp      , Dd          , Gs^Ft       , Gs          , Gs^Eff      , Gs^Eff      
Wo          , Wo          , Wo          , Wo          , Wo          , Wo          , Wo          , Wo          , Wo          , Wo          , Wo          , Wo          , Ww          , Ww          , Ww          , Ww          , Ww          , Ww          , Dd          , Gs          , Rp          , Rp^Vhc      , Rr          , Rr          , Rp          , Rp          , Gs^Ft       , Dd          , Dd^Ecf      , Dd          , Gs^Ft       , Gs          , Gs          , Gs^Eff      
Wo          , Wo          , Wo          , Wo          , Wo          , Wo          , Wo          , Wo          , Wo          , Wo          , Wo          , Wo          , Ww          , Ww          , Ww          , Ww          , Ww          , Ww          , Gs          , Rp          , Rr          , Rr          , Rr          , Rr          , Rr^Vhc      , Gs          , Gs^Ftp      , Dd          , Dd          , Dd          , Gs^Ft       , Gs          , Gs          , Gs          
Wo          , Wo          , Wo          , Wo          , Wo          , Wo          , Wo          , Wo          , Wo          , Wo          , Wo          , Wo          , Ww          , Ww          , Ww          , Ww          , Ww          , Dd^Vda      , Gs          , Rp          , Ch          , Ch          , Rr          , Rr          , Gs          , Gs          , Gs^Ftp      , Gs^Ftp      , Gs^Ftp      , Gs^Ft       , Gs          , Gs          , Gs          , Gs          
Wo          , Wo          , Wo          , Wo          , Wo          , Wo          , Wo          , Wo          , Wo          , Wo          , Wo          , Wo          , Ww          , Ww          , Ww          , Ww          , Ww          , Ww          , Ww^Ftp      , Ch          , 1 Kh        , Ch          , Rp          , Gs          , Gs          , Gs^Ft       , Gs^Gvs      , Gs^Gvs      , Gs^Gvs      , Gs^Gvs      , Gs          , Gs          , Gs          , Gs          
Wo          , Wo          , Wo          , Wo          , Wo          , Wo          , Wo          , Wo          , Wo          , Wo          , Wo          , Wo          , Ww          , Ww          , Ww          , Ww          , Ww^Ft       , Ww^Ftp      , Gs          , Gg^Fet      , Ch          , Ch          , Gs          , Rp          , Rp          , Gs^Ft       , Gs^Gvs      , Gs^Gvs      , Gs          , Gs          , Gs          , Gs          , Gs          , Gs          
