border_size=1
usage=map

Qxu         , Wo          , Xu          , Xu          , Xu          , Xu          , Ww          , Wo          , Wo          , Wo          , Wo          , Ww          , Xu          , Mm^Vhh      , Xu          , Ww          , Ww          , Ww          , Xu          , Ww          , Xu          , Wo          , Xu          , Xu          , Ww          , Xu          , Xu          , Xu          , Xu          , Xuc         , Xuc         , Cud         , Xuc         , Xu          , Xu          , Ww          , Ww          , Wwf         , Hh          , Re          
Xu          , Qxu^Bs|     , Xu          , Wo          , Wo          , Wo          , Wo          , Wo          , Wo          , Wo          , Wo          , Wo          , Wo          , Wo          , Wo          , Wwf         , Ww          , Ww          , Ww          , Wwf         , Wo          , Wo          , Wo          , Wo          , Wo          , Wo          , Wo          , Wo          , Xu          , Uh          , Uu^Uf       , Uu^Es       , Xu          , Ww^Es       , Wo          , Wo          , Wo          , Wo          , Wo          , Ww          
Xu          , Uu          , Uu          , Xu          , Xu          , Wo          , Wo          , Wo          , Wo          , Wo          , Wo          , Wo          , Wo          , Wo          , Wo          , Wo          , Wo          , Ww          , Wo          , Wo          , Wo          , Wo          , Wo          , Wo          , Wo          , Wo          , Wo          , Wo          , Xu          , Uh          , Xu          , Uu          , Xu          , Xu          , Ww^Ewf      , Wo          , Wo          , Wo          , Wo          , Wo          
Uu          , Uu          , Uu          , Uh          , Xu          , Xu          , Xu          , Wo          , Xu          , Wo          , Wo          , Wo          , Xu          , Wo          , Wo          , Wo          , Wo          , Wo          , Wo          , Wo          , Wo          , Wo          , Wo          , Wo          , Wo          , Wo          , Xu          , Wo          , Xu          , Uh          , Ur          , Ur          , Uu          , Xu          , Xu          , Xu          , Xu          , Wo          , Wo          , Wo          
Xu          , Uu          , Cud         , Xu          , Wo          , Xu          , Ur^Vu       , Xu          , Cud         , Xu          , Xu          , Wo          , Wo          , Wo          , Wo          , Wo          , Wo          , Wo          , Wo          , Wo          , Hh^Vc       , Chw         , 2 Khr       , Wo          , Wo          , Cud         , Cud         , Xu          , Ur          , Ur          , Xu          , Xu          , Xu          , Uu          , Uu          , Uu^Vud      , Uu          , Xu          , Ww^Ewl      , Wo          
Wo          , Xu          , Ur          , Xu          , Xu          , Uu^Ii       , Ur          , Ur          , Xu          , Xu          , Wo          , Wo          , Xu          , Wo          , Xu          , Wo          , Wo          , Wo          , Xu          , Xu          , Uh^Dr       , Xu          , Cud         , Xu          , Wo          , Xu          , 5 Kud       , Ur          , Uu          , Ur          , Xu          , Wo          , Wo          , Xu          , Xu          , Uu          , Uu          , Xu          , Ww^Ftp      , Wo          
Wo          , Xu          , Xu          , Ur          , Ur          , Ur          , Xu          , Xu          , Wo          , Wo          , Xu          , Xu          , Urb^Vud     , Xu          , Cud         , Xu          , Xu          , Xu          , Uue^Uf      , Uue         , Uue         , Xu          , Cud         , Xu          , Wo          , Xu          , Xu          , Uu          , Uu          , Ur^Vud      , Xu          , Wo          , Wo          , Wo          , Xu          , Uu          , Xu          , Xu          , Hh^Ftp      , Wo          
Xu          , Wo          , Wo          , Xu          , Xu          , Ur          , Xu          , Wo          , Cud         , Cud         , Urb         , Urb         , Urb         , Urb         , Xu          , Uh          , Uu^Emf      , Uue^Uf      , Uue         , Uue         , Uue         , Xu          , Wo          , Xu          , Xu          , Wo          , Xu          , Uu          , Uu^Vud      , Uu          , Uu^Uf       , Xu          , Xu          , Xu          , Cud         , Cud         , Xu          , Mm          , Ww^Ftp      , Wo^Ftp      
Xu          , Xu          , Xu          , Wo          , Wo          , Xu          , Xu          , Wo          , Cud         , Urb         , Urb         , Urb         , Urb         , Cud         , Xu          , Xu          , Xu          , Uu          , Uu          , Xuce        , Uue         , Xu          , Xu          , Wo          , Wo          , Wo          , Wo          , Xu          , Xu          , Xu          , Xu          , Xu          , Xu          , Uu          , Xu          , Xu          , Wo          , Wo          , Chw         , Chr         
Wwf         , Xu          , Ql          , Xu          , Wo          , Wo          , Wo          , Wo          , Cud         , 6 Kud       , Urb         , Urb         , Cud         , Xu          , Xu          , Wo          , Wo          , Xu          , Ur^Vud      , Uu          , Uu          , Xu          , Wo          , Xu          , Xu          , Xu          , Xu          , Wo          , Wo          , Wo          , Wo          , Wo          , Wo          , Wo          , Wo          , Wo          , Wo          , Xu          , Xuc         , Khw         
Xu          , Xu          , Uh          , Xu          , Xu          , Xu          , Xu          , Wo          , Xu          , Xu          , Xu          , Xu          , Uu^Uf       , Uh          , Uu          , Xu          , Xu          , Xu          , Xu          , Ur          , Ur          , Xu          , Xu          , Wo          , Xu          , Xu          , Xu          , Wo          , Wo          , Wo          , Wo          , Wo          , Wo          , Xu          , Xu          , Xu          , Xu          , Wo^Es       , Xuc         , Cud         
Uh          , Uu^Vu       , Xu          , Xu          , Wo          , Wo          , Wo          , Wo^Xo       , Wo          , Wo          , Wo          , Xu          , Xu          , Xu          , Uu^Emf      , Uu          , Uu          , Xu          , Wo          , Xu          , Xu          , Ur          , Ur          , Xu          , Xu          , Xu          , Wo          , Wo          , Wo          , Wo          , Wo          , Wo          , Xu          , Xu          , Ur^Vud      , Xu          , Xu          , Wo^Fts      , Wo^Fts      , Xuc         
Xu          , Xu          , Wo          , Wo          , Wo          , Wo          , Co          , Ss          , Co          , Wo          , Wo          , Ss          , Ss          , Xu          , Xu          , Uu^Uf       , Uu          , Xu          , Xu          , Wo          , Wo          , Ur^Ii       , Ur^Ii       , Xu          , Wo          , Wo          , Xu          , Xu          , Xu          , Wo          , Wo          , Wo          , Xu          , Xu          , Ur          , Ur          , Uue         , Xu          , Wo^Es       , Wo^Ftp      
          _s,           _s,           _s,           _s,           _s,           _s,           _s,           _s,           _s,           _s,           _s,           _s,           _s,           _s, Xu          , Uu^Uf       , Ur^Vud      , Uu          , Ur          , Xu          , Xu          , Wo          , Ur^Ii       , Xu          , Wo          , Xu          , Xu          , Xu          , Xu          , Xu          , Xu          , Xu          , Ur          , Ur          , Xuce        , Uue         , Xuce        , Uue         , Ur^Ii       , Xuc         
          _s,           _s,           _s,           _s,           _s,           _s,           _s,           _s,           _s,           _s,           _s,           _s,           _s,           _s, Xu          , Xu          , Xu          , Ur          , Xu          , Cud         , Cud         , Xu          , Cud         , Xu          , Xu          , Wo          , Wo          , Wo          , Wo          , Wo          , Xu          , Xu          , Ur          , Xuce        , Uue         , Uue         , Uue         , Uue         , Ur          , Uu          
          _s,           _s,           _s,           _s,           _s,           _s,           _s,           _s,           _s,           _s,           _s,           _s,           _s,           _s,           _s,           _s, Xu          , Xu          , Xu          , Xu          , Xu          , Cud         , Cud         , Cud         , Xu          , Xu          , Wo          , Wo          , Xu          , Wo          , Wo          , Xu          , Ur          , Xuce        , Uue         , Uue         , Xu          , Uue^Vu      , Ur          , Xu          
          _s,           _s,           _s,           _s,           _s,           _s,           _s,           _s,           _s,           _s,           _s,           _s,           _s,           _s,           _s,           _s, Xu          , Xu          , Xu          , Wo          , Wo          , Xu          , Xu          , Cud         , Cud         , Xu          , Wo          , Wo          , Wo          , Wo          , Xu          , Xu          , Ur          , Ur          , Xu          , Xu          , Wo^Fts      , Xu          , Ur          , Xu          
          _s,           _s,           _s,           _s,           _s,           _s,           _s,           _s,           _s,           _s,           _s,           _s,           _s,           _s,           _s,           _s, Xu          , Xu          , Xu          , Wo          , Wo          , Wo          , Xu          , Xu          , Cud         , Xu          , Xu          , Wo          , Xu          , Wo          , Xu          , Xu          , Ur          , Ur          , Xu          , Wo          , Xu          , Xu          , Ur          , Xu          
          _s,           _s,           _s,           _s,           _s,           _s,           _s,           _s,           _s,           _s,           _s,           _s,           _s,           _s,           _s,           _s, Wo          , Xu          , Xu          , Wo          , Wo          , Xu          , Xu          , Ql          , Ql^Bs|      , Ql^Bs\      , Uu^Vu       , Xu          , Xu          , Wo          , Wo          , Xu          , Xu          , Ur          , Uu          , Xu          , Ur^Vud      , Xu          , Ur          , Ur^Vud      
          _s,           _s,           _s,           _s,           _s,           _s,           _s,           _s,           _s,           _s,           _s,           _s,           _s,           _s,           _s,           _s, Wo          , Xu          , Xu          , Xu          , Xu          , Wo          , Wo          , Ql          , Uu          , Ql^Bs/      , Xu          , Xu          , Xu          , Xu          , Wo          , Xu          , Xu          , Uu^Uf       , Uu^Uf       , Uu          , Ur          , Ur          , Uu^Emf      , Xu          
          _s,           _s,           _s,           _s,           _s,           _s,           _s,           _s,           _s,           _s,           _s,           _s,           _s,           _s,           _s,           _s, Wo          , Xu          , 4 Kud       , Cud         , Cud         , Xu          , Uu^Emf      , Uu^Ii       , Uu          , Xu          , Wo          , Wo          , Wo          , Wo          , Wo          , Xu          , Wo          , Xu          , Xu          , Xu          , Xu          , Ur          , Uu          , Xu          
          _s,           _s,           _s,           _s,           _s,           _s,           _s,           _s,           _s,           _s,           _s,           _s,           _s,           _s,           _s,           _s, Wo          , Xu          , Cud         , Cud         , Ur          , Uu          , Uu          , Uu          , Uu^Uf       , Xu          , Wo          , Wo          , Xu          , Wo          , Wo          , Wo          , Wo          , Wo          , Wo          , Xu          , Xu          , Ur          , Ur          , Uu          
          _s,           _s,           _s,           _s,           _s,           _s,           _s,           _s,           _s,           _s,           _s,           _s,           _s,           _s,           _s,           _s, Xu          , Xu          , Cud         , Ur          , Xu          , Uu^Vu       , Xu          , Xu          , Xu          , Xu          , Wo          , Wo          , Wo          , Wo          , Wo          , Xu          , Xu          , Xu          , Xu          , Xu          , Xu          , Ur          , Ur          , Xu          
          _s,           _s,           _s,           _s,           _s,           _s,           _s,           _s,           _s,           _s,           _s,           _s,           _s,           _s,           _s,           _s, Xu          , Xu          , Uu          , Ur          , Xu          , Xu          , Wo          , Wo          , Wo          , Xu          , Wo          , Wo          , Wo          , Wo          , Xu          , Xu          , Xu          , Xu          , Xu          , Xu          , Ur          , Ur          , Ur          , Xu          
          _s,           _s,           _s,           _s,           _s,           _s,           _s,           _s,           _s,           _s,           _s,           _s,           _s,           _s,           _s,           _s, Xu          , Xu          , Uh          , Ur          , Uu^Em       , Wo^Ii       , Xu          , Xu          , Xu          , Wo          , Xu          , Wo          , Wo          , Xu          , Xu          , Xu          , Xu          , Xu          , Xu          , Xu          , Ur          , Ur          , Xu          , Xu          
          _s,           _s,           _s,           _s,           _s,           _s,           _s,           _s,           _s,           _s,           _s,           _s,           _s,           _s, Ss          , Xu          , Xu          , Xu          , Uu^Em       , Ur          , Xu          , Xu          , Xu          , Xu          , Xu          , Xu          , Xu          , Xu          , Xu          , Wo          , Ww^Bs/      , Ur^Vud      , Xu          , Xu          , Ur          , Ur          , Ur          , Ur          , Ur          , Ur          
Xu          , Wo          , Wo          , Ww          , Ww          , Ww          , Ww          , Ww^Vm       , Wo          , Wo          , Wo          , Ss          , Ss          , Ss          , Xu          , Xu          , Xu          , Uh          , Ur          , Ur          , Cud         , Cud         , Ur^Em       , Ur^Em       , Ur^Em       , Uu^Uf       , Uu^Emf      , Xu          , Cud         , Ur          , Xu          , Ur          , Cud         , Ur          , Ur          , Ur          , Ur^Vud      , Ur          , Ur          , Ur          
Xu          , Wo          , Wo          , Wo          , Wo          , Ww          , Wo          , Ww^Bw|      , Wwf         , Wo          , Ss          , Ss          , Ss          , Ss          , Xu          , Xu          , Ur          , Ur          , Ur          , Xu          , Xu          , Xu          , Xu          , Uu^Emf      , Ur^Em       , Ur^Em       , Uu^Vud      , Ur^Em       , Xu          , Xu          , Wo          , Xu          , Xu          , Xu          , Cud         , Cud         , Cud         , Ur          , Xu          , Xu          
Ur          , Xu          , Xu          , Wo          , Xu          , Wo          , Xu          , Ww^Xo       , Xu          , Wwf         , Mm^Vc       , Ss          , Xu          , Xu          , Xu          , Ur          , Ur          , Ur          , Xu          , Xu          , Wo          , Xu          , Xu          , Uu^Uf       , Uu^Uf       , Uu^Uf       , Xu          , Xu          , Xu          , Wo          , Xu          , Xu          , Xu          , Xu          , Xu          , 1 Kud       , Xu          , Xu          , Xu          , Xu          
Ur          , Ur          , Xu          , Xu          , Xu          , Xos         , Cud         , Cud         , Cud         , Xos         , Xu          , Xu          , Uu^Uf       , Uu^Emf      , Uu          , Cud         , Cud         , Xu          , Xu          , Wo^Es       , Xu          , Wo          , Xu          , Xu          , Xu          , Xu          , Xu          , Xu          , Wo          , Wo          , Wo          , Xu          , Wo          , Xu          , Xu          , Xu          , Xu          , Xu          , Wo          , Wo          
Xu          , Cud         , Ur          , Ur          , Ur          , Cud         , Cud         , 3 Kud       , Cud         , Cud         , Ur          , Ur          , Ur          , Uu          , Uu          , Uu^Emf      , Uu^Uf       , Xu          , Cud         , Xu          , Wo          , Wo          , Xu          , Xu          , Xu          , Xu          , Wo          , Wo          , Xu          , Xu          , Xu          , Wo          , Xu          , Wo          , Wo          , Xu          , Wo          , Wo          , Wo          , Wo          
Xu          , Ur^Vud      , Xu          , Ur          , Ur          , Ur          , Ur          , Cud         , Ur          , Ur          , Ur          , Ur          , Xu          , Xu          , Xu          , Uu^Vud      , Xu          , Xu          , Uue         , Xu          , Xu          , Wo          , Wo          , Xu          , Wo          , Wo          , Xu          , Xu          , Uue^Ii      , Uue^Ii      , Xu          , Ww^Es       , Xu          , Wo          , Wo          , Wo          , Wo          , Wo          , Wo          , Wo          
Uue         , Xu          , Uue^Vud     , Xu          , Xu          , Ur          , Ur          , Ur          , Ur          , Ur          , Xu          , Xu          , Xu          , Xu          , Xu          , Xu          , Uue^Emf     , Uue         , Ww          , Xu          , Wo          , Wo          , Wo          , Wo          , Xu          , Xu          , Xu          , Uue^Uf      , Ww          , Ww^Vm       , Wo          , Xu          , Wo          , Ww          , Xu          , Xu          , Xu          , Wo          , Xu          , Xu          
Xu          , Uue^Ufi     , Xu          , Xu          , Xu          , Xu          , Xu          , Xu          , Xu          , Xu          , Xu          , Xu          , Wo          , Wo^Es       , Wo          , Uue^Ii      , Xu          , Ww^Vm       , Wo          , Wo          , Wo          , Wo          , Xu          , Xu          , Xu          , Wwf^Es      , Wo          , Xu          , Wo          , Wo          , Wo          , Wo          , Wo          , Wo          , Xu          , Xu          , Wo          , Wo          , Xu          , Xu          
