border_size=1
usage=map

Wo          , Wo          , Mm          , Mm          , Mm          , Mm          , Mm          , Wo          , Wo          , Wo          , Ds          , Wo          , Wo          , Wo          , Ds          , Ds          , Ds          , Mm          , Mm          , Wwf         , Wo          , Wo          , Wo          , Wo          , Wo          , Wo          , Wo          , Wo          , Wo          , Wo          , Wo          , Wo          , Wo          , Wo          , Wo          , Wo          , Wo          , Wo          , Wo          , Wo          , Wo          , Wo          , Wo          , Wo          , Wo          , Wo          , Wo          , Wo          
Wo          , Wo          , Mm          , Mm          , Mm          , Mm          , Mm          , Ww          , Ww          , Ds          , Ww          , Wo          , Wo          , Ds          , Mm          , Mm          , Mm          , Mm^Xm       , Mm          , Wwf         , Wo          , Wo          , Wo          , Wo          , Wo          , Wo          , Wo          , Wo          , Wo          , Wo          , Wo          , Wo          , Wo          , Mm^Xm       , Mm^Xm       , Wo          , Wo          , Wo          , Wo          , Wo          , Ch          , Wo          , Wo          , Wo          , Wo          , Wo          , Wo          , Wo          
Wo          , Wo          , Wwf         , Mm          , Ww          , Mm          , Ww          , Ww          , Ww          , Ww          , Wo          , Wo          , Wo          , Mm          , Mm          , Mm          , Mm^Xm       , Mm          , Mm          , Ch          , Wo^Bw\      , Wo          , Wo          , Wo          , Wo          , Wo          , Wo          , Wo          , Wo          , Wo          , Mm^Xm       , Mm^Xm       , Wo          , Wo          , Wo          , Mm^Xm       , Mm^Xm       , Ch          , Wo^Bw\      , Wo^Bw/      , Wo          , Wo^Bw\      , Wo^Bw/      , Ch          , Wo^Bw\      , Wo          , Wo          , Wo          
Ds          , Wo          , Ds          , Ww          , Ww          , Ww          , Ww          , Ww          , Wo          , Wo          , Wo          , Wo          , Mm          , Mm^Xm       , Mm          , Mm          , Mm          , Mm          , Mm          , Wo          , Wo          , Wo^Bw\      , Ch          , Ch          , Ch          , Wo          , Wo          , Wo          , Wo          , Mm^Xm       , Mm          , Mm^Xm       , Mm          , Mm^Xm       , Mm          , Mm^Xm       , Mm          , Mm          , Wo          , Wo          , Wo          , Wo          , Mm          , Mm          , Wo          , Wo^Bw\      , Ch          , Wo          
Ww          , Ds          , Ds          , Ww          , Ww          , Ww          , Ds          , Ds          , Ww          , Wo          , Wo          , Mm          , Mm          , Mm^Xm       , Mm^Xm       , Mm          , Mm          , Mm          , Wo          , Wo          , Wo          , Wo          , Mm          , 3 Kh        , Wo          , Wo^Bw\      , Wo^Bw/      , Ch          , Ww          , Mm^Xm       , Mm^Xm       , Mm          , Ds          , Hd          , Ds          , Mm          , Mm          , Wo          , Wo          , Wo          , Wo          , Wo          , Wo          , Wo          , Wo          , Wo          , Re          , Wo          
Ww          , Ww          , Ww          , Ww          , Ww          , Ww          , Ww          , Ds          , Ww          , Wo          , Wo          , Mm          , Mm          , Mm          , Mm          , Mm          , Wwr         , Wo          , Wo          , Wo          , Wo          , Wo          , Mm          , Mm          , Wo          , Wo          , Wo          , Mm          , Mm          , Mm          , Mm^Xm       , Ww          , Ww          , Ds          , Ds          , Mm          , Mm          , Wo          , Wo          , Wo          , Wo          , Wo          , Ww          , Mm          , Mm          , Re          , Mm          , Mm^Vhh      
Dd          , Ww          , Ww          , Ww          , Ww          , Ww          , Ww          , Ww          , Ww          , Wo          , Wo          , Mm          , Mm          , Mm          , Mm          , Mm          , Wwr         , Wo          , Wo          , Wo          , Wo          , Wo          , Wo          , Ds          , Wo          , Wo          , Wo          , Mm          , Mm^Xm       , Mm^Xm       , Ww          , Ww          , Ww          , Ww          , Ww          , Ds          , Mm          , Wo          , Wo          , Wo          , Ww          , Ww          , Ds          , Dd^Vdt      , Mm          , Re          , Mm          , Mm          
Dd          , Dd          , Ww          , Ww          , Dd          , Dd          , Dd          , Dd          , Ww          , Wo          , Wo          , Wo          , Wo          , Mm          , Mm          , Mm          , Wwr         , Wwr         , Wo          , Wo          , Mm          , Wo          , Wo          , Wo          , Mm          , Wo          , Wo          , Mm          , Mm          , Ww          , Ww          , Ww^Vm       , Ww          , Ww          , Ww          , Ww          , Ww          , Wo          , Mm          , Ds          , Ds          , Ds          , Mm          , Mm          , Mm          , Re          , Mm          , Mm          
Gs          , Gs          , Gs^Ftd      , Dd^Ftd      , Dd          , Dd          , Dd          , Dd          , Ww          , Wo          , Wo          , Wo          , Wo          , Wo          , Mm          , Mm          , Mm          , Wwr         , Mm          , Mm          , Mm          , Mm          , Mm          , Wo          , Wo          , Wo          , Mm          , Wo          , Mm          , Ww          , Ww          , Ww          , Ww          , Ww          , Mm          , Ww          , Ch          , Ch          , Hh          , Hd          , Hh          , Ds          , Mm          , Mm          , Mm          , Re          , Mm          , Md          
Gs          , Gs          , Gs          , Gs^Ftd      , Dd          , Dd^Vda      , Dd          , Dd          , Gs          , Ww          , Wo          , Wo          , Wo          , Wo          , Mm          , Mm          , Mm          , Mm          , Mm          , Mm          , Mm          , Mm          , Mm          , Wo          , Mm          , Mm          , Mm          , Wo          , Mm          , Mm          , Ww          , Ww          , Ww          , Ww          , Mm          , Mm          , Kh          , Ch          , Hh          , Hh          , Re          , Re          , Re          , Re          , Re          , Re          , Rd          , Rd          
Gs          , Gs          , Gs          , Gs          , Gs          , Dd          , Gs^Ft       , Gs          , Gs          , Ww          , Wo          , Wo          , Wo          , Wo          , Mm          , Mm          , Mm          , Mm          , Mm          , Mm          , Re          , Mm          , Mm          , Mm          , Mm          , Mm          , Mm          , Wo          , Wo          , Mm          , Mm          , Hh          , Hh          , Hh          , Hh          , Ch          , Ch          , 4 Kh        , Re          , Re          , Hh          , Hh          , Hh          , Hh          , Hd          , Hh          , Mm          , Mm          
Gs          , Ch          , Kh          , Ch          , Gs          , Gs          , Gs          , Gs          , Gs          , Ss          , Ss          , Wo          , Mm          , Mm          , Mm          , Mm          , Re          , Mm          , Re          , Re          , Ww          , Re          , Ww^Bw\      , Mm          , Mm          , Mm          , Mm          , Mm          , Ww          , Wwf         , Mm          , Mm          , Re          , Re          , Re          , Re          , Re          , Re          , Hh^Gvs      , Re          , Re          , Hh          , Hh          , Hd          , Hd          , Hh          , Hh          , Mm          
Gs          , Ch          , Ch          , Ch          , Gs          , Gs          , Gs          , Gs          , Gs          , Ss          , Rd          , Mm          , Mm          , Mm          , Re          , Re          , Mm          , Re          , Mm          , Wwf         , Mm          , Ww          , Ww          , Re          , Ch          , Mm          , Re          , Re          , Ww^Bh\      , Ww          , Re          , Re          , Gs          , Gs^Efm      , Hh^Efm      , Hh          , Hh^Gvs      , Hh^Gvs      , Hh^Gvs      , Hh^Gvs      , Hh^Gvs      , Re          , Hh          , Hh          , Hh          , Hh          , Ww          , Mm          
Re          , Re          , Ch          , Dd          , Dd          , Dd          , Gs^Ft       , Gs          , Rd          , Rd          , Hh          , Re          , Re          , Re          , Mm          , Mm          , Mm          , Mm          , Mm          , Mm          , Mm          , Mm          , Mm          , 2 Kh        , Ch          , Ww^Bh/      , Mm          , Mm          , Ww          , 1 Ch        , Ww          , Gs          , Gs^Vht      , Ww          , Ww          , Hh^Gvs      , Hh^Gvs      , Hh^Gvs      , Hh^Gvs      , Hh^Gvs      , Gs^Ft       , Re          , Hh          , Hh          , Hh          , Hh          , Ww          , Ww          
Re          , Gs^Ft       , Dd          , Rd          , Rd          , Dd          , Rd          , Rd          , Hh^Ft       , Hh^Ft       , Hh          , Hh          , Mm          , Mm          , Mm          , Mm          , Mm          , Mm          , Mm          , Mm          , Mm          , Mm          , Mm          , Wwg         , Ww          , Ww          , Mm^Vhh      , Ww          , Mm          , Mm          , Ww          , Ww          , Ww          , Ww          , Ww          , Ww          , Ww          , Hh^Gvs      , Gs^Ft       , Gs^Ft       , Gs^Ft       , Re          , Gg          , Gs^Ft       , Gs^Ft       , Hh          , Ww          , Hh          
Re          , Gs^Ft       , Dd          , Dd^Vda      , Dd          , Rd          , Dd          , Gs^Ft       , Hh^Ft       , Hh^Ft       , Mm          , Hh          , Hh          , Mm          , Mm          , Mm          , Mm          , Mm          , Mm          , Mm          , Mm          , Mm          , Mm          , Ch          , Mm          , Ww          , Ww          , Ww          , Mm          , Mm          , Mm          , Ww          , Ww          , Ww          , Ww          , Ww          , Hh          , Ww          , Gs^Ft       , Ww          , Gs          , Re          , Re          , Gs^Ft       , Ds          , Dd^Vdt      , Ww          , Ww          
Rd          , Gs^Ft       , Gs^Ft       , Dd          , Dd          , Dd          , Dd          , Ds          , Hh          , Hh          , Mm          , Hh          , Hh          , Hh          , Hh          , Mm          , Mm          , Mm          , Mm          , Mm          , Mm          , Mm          , Mm          , Mm          , Mm          , Ww          , Mm          , Mm          , Mm          , Mm          , Mm          , Hh          , Ww          , Ww          , Ww          , Ww          , Hh          , Ww          , Ww          , Ww          , Ww          , Gs          , Re          , Gg          , Ds          , Ww          , Ww          , Ww          
