border_size=1
usage=map

Wo          , Wo^Bw\      , Ch          , Ch          , Ch          , Wo          , Wo          , Wo          , Wo          , Mm^Xm       , Mm          , Mm^Xm       , Mm          , Mm^Xm       , Mm          , Mm^Xm       , Mm          , Mm          , Wo          , Wo          , Wo          , Wo          , Mm          , Mm          , Wo          , Wo^Bw\      , Ch          , Wo          , Wo          , Wo          , Wo          , Wo          , Wo          , Wo          , Wo          , Wo          , Wo          , Wo          , Wo          , Mm          , Mm          , Mm          , Mm          , Mm          , Mm          , Ww^Vm       , Ww          , Ww          
Wo          , Wo          , Mm          , Kh          , Wo          , Wo^Bw\      , Wo^Bw/      , Ch          , Ww          , Mm^Xm       , Mm^Xm       , Mm          , Ds          , Hd          , Ds          , Mm          , Mm          , Wo          , Wo          , Wo          , Wo          , Wo          , Wo          , Wo          , Wo          , Wo          , Re          , Wo          , Wo          , Wo          , Wo          , Wo          , Wo          , Wo          , Wo          , Wo          , Wo          , Wo          , Wo          , Wo          , Wo          , Wwf         , Ww          , Ww          , Ww          , Ww          , Ww          , Ww          
Wo          , Wo          , Mm          , Mm          , Wo          , Wo          , Wo          , Mm          , Mm          , Mm          , Mm^Xm       , Ww          , Ww          , Ds          , Ds          , Mm          , Mm          , Wo          , Wo          , Wo          , Wo          , Wo          , Ww          , Mm          , Mm          , Re          , Mm          , Mm^Vhh      , Ww          , Wo          , Ww          , Wo          , Wo          , Wo          , Wo          , Wo          , Wo          , Wo          , Wo          , Wo          , Wo          , Wo          , Wo          , Wo          , Wo          , Wo          , Wo          , Ds          
Wo          , Wo          , Wo          , Ds          , Wo          , Wo          , Wo          , Mm          , Mm^Xm       , Mm^Xm       , Ww          , Ww          , Ww          , Ww          , Ww          , Ds          , Mm          , Wo          , Wo          , Wo          , Ww          , Ww          , Ds          , Dd^Vdt      , Mm          , Re          , Mm          , Mm          , Ww          , Ww          , Ds          , Ww          , Ds          , Wo          , Ds          , Ds          , Ds          , Ww          , Ww          , Wo          , Wo          , Wo          , Wo          , Wo          , Wo          , Wo          , Wo          , Ww          
Mm          , Wo          , Wo          , Wo          , Mm          , Wo          , Wo          , Mm          , Mm          , Ww          , Ww          , Ww^Vm       , Ww          , Ww          , Ww          , Ww          , Ww          , Wo          , Mm          , Ds          , Ds          , Ds          , Mm          , Mm          , Mm          , Re          , Mm          , Mm          , Md          , Hd          , Ds          , Ds          , Ds          , Ds          , Ds          , Ds          , Ds          , Ds          , Ds          , Ww          , Ww          , Wo          , Wo          , Wo          , Wo          , Wo          , Wo          , Wo          
Mm          , Mm          , Mm          , Wo          , Wo          , Wo          , Mm          , Wo          , Mm          , Ww          , Ww          , Ww          , Ww          , Ww          , Mm          , Ww          , Ch          , Ch          , Hh          , Hd          , Hh          , Ds          , Mm          , Mm          , Mm          , Re          , Mm          , Md          , Rd          , Rd          , Rd          , Ds          , Dd^Vda      , Ds          , Mm          , Ds          , Ds          , Ds          , Ds          , Ds          , Ds          , Ww          , Ww          , Wo          , Wo          , Wo          , Wo          , Wo          
Mm          , Mm          , Mm          , Wo          , Mm          , Mm          , Mm          , Wo          , Mm          , Mm          , Ww          , Ww          , Ww          , Ww          , Mm          , Mm          , Kh          , Ch          , Hh          , Hh          , Re          , Re          , Re          , Re          , Re          , Re          , Rd          , Rd          , Mm          , Mm          , Mm          , Rd          , Rd          , Mm          , Mm          , Mm          , Md          , Ds          , Ds          , Ds          , Ds          , Ds          , Ww          , Ww          , Wo          , Wo          , Wo          , Wo          
Re          , Mm          , Mm          , Mm          , Mm          , Mm          , Mm          , Wo          , Wo          , Mm          , Mm          , Hh          , Hh          , Hh          , Hh          , Ch          , Ch          , 2 Kh        , Re          , Re          , Hh          , Hh          , Hh          , Hh          , Hd          , Hh          , Mm          , Mm          , Mm          , Mm          , Mm          , Mm          , Mm          , Rd          , Rd          , Rd          , Rd          , Ds          , Ds          , Ds          , Ds          , Ds          , Ww          , Ww          , Ww          , Wo          , Wo          , Wo          
Ww          , Re          , Ww^Bw\      , Mm          , Mm          , Mm          , Mm          , Mm          , Ww          , Wwf         , Mm          , Mm          , Re          , Re          , Re          , Re          , Re          , Re          , Hh^Gvs      , Re          , Re          , Hh          , Hh          , Hd          , Hd          , Hh          , Hh          , Mm          , Mm          , Mm          , Mm          , Mm          , Mm          , Mm          , Mm          , Mm          , Mm          , Rd          , Rd          , Ds          , Ds          , Ds          , Ds          , Ww          , Ww          , Ww          , Wo          , Wo          
Mm          , Ww          , Ww          , Re          , Ch          , Mm          , Re          , Re          , Ww^Bh\      , Ww          , Re          , Re          , Gs          , Gs^Efm      , Hh^Efm      , Hh          , Hh^Gvs      , Hh^Gvs      , Hh^Gvs      , Hh^Gvs      , Hh^Gvs      , Re          , Hh          , Hh          , Hh          , Hh          , Ww          , Mm          , Mm          , Mm          , Mm          , Mm          , Mm          , Mm          , Mm          , Mm          , Mm          , Mm          , Mm          , Rd          , Rd          , Ds          , Ds          , Ds          , Ww          , Ww          , Ww          , Wo          
Mm          , Mm          , Mm          , 3 Kh        , Ch          , Ww^Bh/      , Mm          , Mm          , Ww          , Ch          , Ww          , Gs          , Gs^Vht      , Ww          , Ww          , Hh^Gvs      , Hh^Gvs      , Hh^Gvs      , Hh^Gvs      , Hh^Gvs      , Gs^Ft       , Re          , Hh          , Hh          , Hh          , Hh          , Ww          , Ww          , Ww          , Mm          , Mm          , Mm          , Mm          , Mm          , Mm          , Mm          , Mm          , Mm          , Mm          , Mm          , Mm          , Rd          , Rd          , Ds          , Ds          , Ww          , Ww          , Wo          
Mm          , Mm          , Mm          , Wwg         , Ww          , Ww          , Mm^Vhh      , Ww          , Mm          , Mm          , Ww          , Ww          , Ww          , Ww          , Ww          , Ww          , Ww          , Hh^Gvs      , Gs^Ft       , Gs^Ft       , Gs^Ft       , Re          , Gg          , Gs^Ft       , Gs^Ft       , Hh          , Ww          , Hh          , Hh          , Ww          , Mm          , Mm          , Mm          , Mm          , Mm          , Mm          , Mm          , Mm          , Mm          , Mm          , Mm          , Mm          , Rd          , Ds          , Ds          , Ww          , Ww          , Ww          
Mm          , Mm          , Mm          , Ch          , Mm          , Ww          , Ww          , Ww          , Mm          , Mm          , Mm          , Ww          , Ww          , Ww          , Ww          , Ww          , Hh          , Ww          , Gs^Ft       , Ww          , Gs          , Re          , Re          , Gs^Ft       , Ds          , Dd^Vdt      , Ww          , Ww          , Hh          , Ww          , Mm          , Mm          , Mm          , Mm          , Mm          , Mm          , Mm          , Mm          , Mm          , Mm          , Mm          , Mm          , Mm          , Rd          , Ds          , Ds          , Ds          , Ww          
Mm          , Mm          , Mm          , Mm          , Mm          , Ww          , Mm          , Mm          , Mm          , Mm          , Mm          , Hh          , Ww          , Ww          , Ww          , Ww          , Hh          , Ww          , Ww          , Ww          , Ww          , Gs          , Re          , Gg          , Ds          , Ww          , Ww          , Ww          , Chw         , Ww          , Mm          , Mm          , Mm          , Mm          , Mm          , Mm          , Mm          , Mm          , Mm          , Mm          , Mm          , Mm          , Hh          , Hh          , Dd^Vdt      , Ds          , Ds          , Ds          
Mm          , Mm          , Ww          , Mm          , Mm          , Mm          , Mm          , Mm          , Mm          , Mm          , Mm          , Hh          , Ww          , Ww          , Ww          , Ww          , Ww          , Ww          , Dd^Vdt      , Gg          , Ww          , Gs          , Re          , Gs^Ft       , Gs^Ft       , Ww          , Ww          , Ww          , Chw         , Ww          , Mm          , Mm          , Mm          , Mm          , Ww          , Mm          , Hh^Vhr      , Mm          , Ww          , Mm          , Mm          , Mm          , Hh          , Hh          , Gs^Ft       , Gs^Ft       , Gs^Ft       , Ds          
Mm          , Ww          , Mm          , Ww          , Ww          , Mm          , Ww          , Mm          , Mm          , Mm          , Mm          , Hh          , Ww          , Hh          , Hh          , Hh          , Gg          , Ds          , Gg          , Gg          , Ww          , Gs          , Gs          , Re          , Ww          , Ww          , Gs^Ft       , Ww          , Ww          , Ww          , Ww          , Mm          , Mm          , Ww          , Ww          , Ww          , Ww          , Ww          , Wwf         , Mm          , Ww          , Mm          , Ww          , Hh          , Ww          , Ww          , Ww          , Gs^Ft       
Mm          , Ww          , Ww          , Ww          , Mm          , Ww          , Mm          , Ww          , Ww          , Mm          , Ww          , Ww          , Ww          , Hh          , Ww          , Ww          , Hh          , Gg          , Gg          , Gg          , Gg^Vo       , Ww          , Ww          , Ww^Bh|      , Ww          , Ww          , Ds          , Ww          , Ww          , Ww          , Ww          , Ww          , Ww          , Ww          , Mm^Vhh      , Ww          , Mm          , Mm          , Mm          , Ww^Bw|      , Chs         , Ww          , Ss^Vhs      , Ww          , Gs^Ft       , Gs^Ft       , Ww          , Ww          
Ww          , Ww          , Ww          , Ww          , Ww          , Ww          , Mm          , Ww          , Mm          , Ww          , Mm          , Mm          , Ww          , Hh          , Ww          , Ww          , Wwf         , Ww          , Ww          , Gg          , Gg          , Ww          , Ww          , Ww^Bh|      , Ww          , Gs^Ft       , Gg          , Ww          , Ww          , Ww          , Ww          , Ww          , Ww          , Ww          , Mm          , Mm          , Mm          , Mm          , Mm          , Mm          , Hh          , Ss          , Gs          , Gs^Ft       , Gs^Ft       , Gs^Ft       , Gs^Ft       , Gs^Ft       
Ww          , Ww          , Ww^Vm       , Ww          , Ww          , Ww          , Ww          , Mm          , Mm          , Mm          , Mm          , Mm          , Ww          , Mm^Xm       , Wwf         , Hh          , Hh          , Hh          , Ww          , Gg          , Ww^Bw\      , Ww          , Gg          , Ww^Bh|      , Ww          , Gg          , Gg          , Ww          , Ww          , Ww          , Ww          , Mm          , Mm          , Mm          , Mm          , Mm          , Mm          , Mm          , Mm          , Hh          , Hh          , Hh          , Ds          , Gs^Ft       , Gs^Ft       , Gs^Ft       , Gs^Ft       , Gs^Ft       
Ww          , Ww          , Ww          , Ww          , Mm          , Mm          , Mm          , Mm          , Mm^Xm       , Mm^Xm       , Mm^Xm       , Mm          , Mm          , Wwf         , Hh          , Hh          , Hh          , Hh          , Hh          , Ww          , Gs^Fds      , Gg          , Gg          , Re          , Re          , Gg          , Gs^Vht      , Ww          , Ww          , Ww          , Ww          , Mm          , Mm          , Mm          , Mm          , Mm          , Mm          , Mm          , Mm          , Hh          , Hh          , Hh          , Ds          , Gs^Ft       , Gs^Ft       , Gs^Ft       , Gs^Ft       , Gs^Ft       
Ww          , Mm          , Ww          , Ww          , Mm          , Mm          , Mm          , Mm          , Mm          , Mm^Xm       , Mm^Xm       , Mm^Xm       , Mm          , Mm          , Mm          , Mm          , Hh          , Hh          , Hh          , Hh^Fds      , Hh^Fds      , Gs^Fds      , Hh          , Hh          , Hh          , Re          , Re          , Ww          , Ww          , Ww          , Hh          , Mm          , Mm          , Mm          , Mm          , Mm          , Mm          , Mm          , Hh          , Hh          , Hh          , Ds          , Ds          , Gg          , Gs^Ft       , Gs^Ft       , Gs^Ft       , Gs^Ft       
Mm          , Mm          , Mm          , Ww          , Mm          , Mm          , Mm          , Mm          , Mm          , Mm          , Mm          , Mm          , Mm          , Mm          , Mm          , Mm          , Mm          , Mm          , Hh          , Hh^Fds      , Hh^Fds      , Hh^Fds      , Hh^Fds      , Hh          , Hh          , Hh          , Hh          , Ww^Bw\      , Ww^Bw\      , Ww          , Mm          , Mm          , Mm          , Mm          , Mm          , Mm          , Mm          , Mm          , Hh          , Hh          , Hh          , Ds          , Ds          , Gg          , Dd^Vdt      , Gg          , Ww          , Ww          
Mm^Xm       , Mm^Xm       , Mm^Xm       , Mm          , Mm          , Mm          , Mm          , Mm          , Ww          , Ww          , Ww          , Mm          , Mm          , Mm          , Mm          , Mm          , Mm          , Mm          , Mm          , Hh^Fds      , Hh^Fds      , Hh^Fds      , Hh          , Hh          , Hh          , Hh          , Hh          , Ww          , Mm^Vhh      , Re          , Mm          , Mm          , Mm          , Mm          , Mm          , Mm          , Mm          , Ww          , Ww          , Hh          , Ww          , Ww          , Ww          , Ds          , Ds          , Ds          , Ww          , Ww          
Mm          , Mm^Xm       , Mm^Xm       , Mm          , Mm          , Mm          , Mm          , Mm          , Mm^Xm       , Ww          , Ww          , Mm          , Mm          , Mm          , Mm          , Mm          , Mm          , Mm          , Mm          , Mm          , Mm          , Hh^Fds      , Hh          , Hh          , Hh          , Hh          , Hh          , Mm          , Mm          , Re          , Re          , Mm          , Mm          , Mm          , Wwf         , Ww          , Ww          , Ww          , Ww          , Ww          , Gs^Vht      , Ww          , Ww          , Wwf         , Ww          , Ww          , Gs^Ft       , Gs^Ft       
Mm          , Mm          , Mm          , Mm          , Mm          , Mm          , Mm          , Mm          , Ww          , Ww          , Wo          , Ww          , Mm          , Mm          , Ww          , Mm          , Mm          , Mm          , Mm          , Mm          , Mm          , Mm          , Mm          , Mm          , Hh          , Mm          , Mm          , Mm          , Mm          , Mm          , Mm          , Re          , Mm          , Ww          , Wwf         , Ww          , Mm          , Ww          , Hh          , Gs^Ft       , Gs^Ft       , Gg          , Gg          , Wwf         , Gs^Ft       , Gs^Ft       , Gs^Ft       , Gs^Ft       
Mm          , Mm          , Ww          , Mm          , Mm          , Mm          , Mm          , Ww          , Ww          , Wo          , Wo          , Ww          , Ww          , Mm          , Ww          , Ww          , Ww          , Mm          , Ww          , Mm          , Mm          , Mm          , Mm          , Mm          , Mm          , Mm          , Ww          , Ww          , Ww          , Mm          , Mm^Vhh      , Re          , Ww^Bh\      , Ww          , Hh^Vhh      , Mm          , Mm          , Mm          , Re          , Hh          , Gs^Ft       , Gg          , Gs^Ft       , Gg          , Gg^Vo       , Gs^Ft       , Gs^Ft       , Gs^Ft       
Mm          , Mm          , Ww          , Ww          , Mm          , Mm          , Mm          , Mm          , Ww          , Wo          , Ww          , Ww          , Wwf         , Ww          , Mm          , Mm          , Mm          , Ww          , Ww          , Mm          , Mm          , Mm          , Mm          , Mm          , Wwf         , Ww          , Xu          , Xu          , Ww          , Ww          , Ww          , Ww          , Xu          , Re          , Re          , Hh          , Re          , Re          , Xu          , Re          , Re          , Gg          , Re          , Re          , Gg          , Gs^Ft       , Gs^Ft       , Gs^Ft       
Wwf         , Ww          , Mm          , Wo          , Wo          , Mm          , Mm          , Mm^Xm       , Mm^Xm       , Ww          , Mm          , Mm          , Ww          , Mm          , Mm          , Mm          , Mm          , Mm^Ftp      , Ww          , Mm          , Mm          , Mm          , Mm          , Mm          , Ww          , Xu          , Xu          , Ww          , Ww          , Ww          , Ww          , Xu          , Xuc         , Xu          , Xu          , Re          , Xu          , Xu          , Xu          , Hh          , Hh          , Re          , Re          , Gs^Ft       , Gg          , Gs^Ft       , Gs^Ft       , Gs^Ft       
Mm          , Ww          , Mm          , Wo          , Wo          , Wo          , Mm          , Mm          , Ww          , Mm          , Mm          , Mm          , Mm          , Mm          , Mm          , Mm          , Mm^Ftp      , Mm^Ftp      , Ww          , Hh^Vhh      , Mm          , Mm          , Ww          , Ww          , Xu          , Ww          , Ww          , Ww          , Ww          , Ww          , Ww          , Xu          , Xuc         , Uu^Vu       , Uu          , Xu          , Uu^Vu       , Xu          , Xu          , Hh          , Hh^Fds      , Gs^Fds      , Re          , Gg          , Gg          , Gg          , Gg          , Gs^Ft       
Mm          , Mm          , Mm          , Mm          , Mm          , Wo          , Ww          , Mm          , Ww          , Ww          , Mm          , Mm          , Mm          , Mm          , Ww          , Mm^Ftp      , Ww^Ftp      , Hh^Ftp      , Wo^Ftp      , Ww          , Ww          , Mm          , Ww          , Xu          , Xu          , Ww          , Xu          , Ww          , Ww          , Xu          , Ww          , Xu          , Kud         , Cud         , Xuc         , Uu          , Xu          , Xu          , Xu          , Hh          , Gs^Fds      , Gs^Fds      , Re          , Gg          , Gg          , Gs^Ft       , Gg          , Ss          
Mm          , Mm          , Mm          , Mm          , Mm          , Mm          , Ww          , Ww          , Mm          , Ww          , Mm          , Mm          , Mm          , Ww          , Ww^Vm       , Ww          , Ww^Ftp      , Ww^Ftp      , Xuc         , Xuc         , Xuc         , Ww          , Xu          , Xu          , Uu^Vud      , Xu          , Xuc         , Xu          , Xuc         , Xu          , Xu          , Xu          , Xuc         , Cud         , Uu          , Uu          , Xuc         , Xu          , Xu          , Gs^Fds      , Gs^Fds      , Gs^Fds      , Gg^Ve       , Re          , Gg          , Gg          , Gg          , Gg          
Mm          , Mm          , Mm          , Mm          , Mm          , Mm          , Ww          , Ww          , Mm          , Ww          , Mm          , Mm          , Ww          , Ww          , Wo          , Ww          , Xu          , Xuc         , Uu^Vud      , Uu^Br/      , Uu^Br\      , Xuc         , Xuc         , Xuc         , Uu^Br\      , Xuc         , Ww^Br\      , Xuc         , Ww^Br/      , Uu          , Uu^Br/      , Uu^Br\      , Uu^Br\      , Xuc         , Xuc         , Uu          , Uu          , Uu^Vu       , Xu          , Gs^Fds      , Gs^Fds      , Gs^Fds      , Re          , Re          , Re          , Gg          , Re          , Gg          
Mm          , Mm          , Mm          , Mm          , Mm          , Mm          , Mm          , Mm          , Mm          , Ww          , Mm          , Ww          , Wo          , Wo          , Wo          , Ww          , Xu          , Xuc         , Xuc         , Uue         , Uue^Br/     , Uu^Br\      , Uu^Br/      , Uu^Br/      , Xuc         , Ww^Br/      , Ww          , Ww^Br\      , Wo          , Ww^Br\      , Xu          , Xuc         , Xuc         , Uu^Br\      , Uu^Br\      , Uu          , Xuc         , Xu          , Xu          , Hh          , Hh          , Hh^Fds      , Re          , Gg          , Gg          , Re          , Gg          , Re          
Mm          , Mm          , Mm          , Mm          , Mm          , Mm          , Mm          , Mm          , Mm          , Ww          , Ww          , Ww          , Ww          , Wo          , Ww          , Ww          , Ww          , Ww          , Xu          , Uue^Br|     , Xuce        , Xuce        , Xuce        , Uu^Br|      , Uu^Br\      , Xuc         , Xuc         , Wo          , Wo          , Wo          , Ww          , Xu          , Xu          , Xuc         , Xuc         , Uu^Br|      , Uu          , Xu          , Hh          , Hh          , Hh^Fds      , Ch          , Ch          , Ch          , Gg          , Gg          , Gg          , Gg          
Mm          , Mm          , Mm          , Mm          , Ww          , Ww          , Ww          , Mm          , Mm          , Mm          , Mm          , Mm          , Ww          , Mm^Ftp      , Ww^Ftp      , Mm^Ftp      , Ww          , Xu          , Xu          , Uue^Br|     , Uue^Br\     , Uue^Vud     , Xuce        , Xuc         , Xuc         , Uu^Br|      , Uu^Br\      , Xuc         , Ww          , Wo          , Ww          , Ww          , Xuc         , Xuc         , Uu^Br/      , Uu^Br|      , Uu^Uf       , Xu          , Hh          , Hh^Fds      , Hh^Fds      , Ch          , 1 Kh        , Ch          , Gg          , Gg          , Gg          , Hh^Ft       
Mm          , Mm          , Mm          , Mm          , Mm          , Ww          , Wo          , Ww          , Mm          , Mm          , Mm          , Mm          , Mm          , Mm          , Mm^Ftp      , Mm^Ftp      , Wwf         , Ww          , Ww          , Xu          , Xu          , Uue^Br/     , Uue         , Uu          , Uu          , Xuc         , Uu^Br|      , Xuc         , Xuc         , Ww          , Ww          , Xu          , Uu          , Uu^Br\      , Xu          , Uu^Br|      , Xu          , Xu          , Hh          , Hh^Fds      , Hh^Fds      , Ch          , Ch          , Gg          , Gg          , Gg          , Gg          , Hh^Fds      
Mm          , Mm          , Ww          , Ww          , Ww          , Ww          , Wo          , Ww          , Mm          , Mm          , Mm          , Mm          , Mm          , Mm          , Mm          , Mm^Ftp      , Mm          , Wo          , Wo          , Ww          , Ww          , Xu          , Xu          , Uu          , Uh          , Xuc         , Xuc         , Cud         , Xuc         , Ww          , Ww          , Xu          , Uu          , Uu          , Xu          , Cud         , Mm^Vhh      , Xu          , Hh          , Hh^Fds      , Hh^Fds      , Hh^Fds      , Re          , Gg          , Gg          , Gg          , Gg          , Hh^Fds      
Mm          , Mm          , Mm          , Ww          , Ww^Vm       , Wo          , Wo          , Ww          , Ww          , Mm          , Mm          , Mm          , Mm          , Mm          , Mm          , Mm          , Ww          , Mm          , Mm          , Wo          , Ww          , Xu          , Wwf         , Xu          , Uh          , Uh          , Xuc         , Cud         , Cud         , Xuc         , Wwf         , Xu          , Xu          , Xu          , Xu          , Xu          , Xu          , Re          , Hh          , Hh^Fds      , Gs^Fds      , Gg          , Re          , Gg          , Gg          , Gg          , Gg          , Gg          
Mm          , Mm          , Mm          , Ww          , Ww          , Wo          , Wo          , Wo          , Ww          , Mm          , Ww          , Ww          , Ww          , Mm          , Mm          , Mm          , Ww          , Ww          , Mm          , Wo          , Xu          , Ww          , Ww          , Xu          , Uh          , Uh          , Uh          , Xuc         , Cud         , Xuc         , Xuc         , Wwf         , Ww          , Ww^Es       , Wwf         , Hh          , Hh          , Re          , Hh          , Gs^Fds      , Re          , Re          , Hh^Fds      , Hh          , Gg          , Gg          , Gg          , Ds          
Mm^Xm       , Mm          , Mm          , Mm          , Ww          , Wo          , Wo          , Wo          , Wo          , Ww          , Mm          , Mm^Vhh      , Mm          , Ww          , Ww          , Ww          , Khr         , Ww          , Mm          , Wo          , Xu          , Xu          , Ww          , Xu          , Xu          , Xu          , Xu          , Xuc         , Xuc         , Cud         , Xuc         , Xu          , Xu          , Ww          , Ww          , Wwf         , Hh          , Re          , Re          , Re          , Hh^Fds      , Hh^Fds      , Hh^Fds      , Hh          , Hh          , Hh          , Ds          , Ds          
