border_size=1
usage=map

Mm          , Mm          , Wwf         , Ww          , Ww          , Ww          , Ww          , Ww          , Gs^Vht      , Ww          , Ww          , Wwf         , Ww          , Ww          , Gs^Ft       , Gs^Ft       , Ss          , Ww          , Wo          , Wo          , Wo          , Ss          , Ss          , Ss          , Wo          , Wo          , Wo          , Wo          , Wo          , Wo          , Wo          , Wo          , Wo          , Wo          , Wo          , Wo          , Wo          , Wo          , Wo          , Wo          , Wo          , Wo          , Wo          , Wo          
Mm          , Ww          , Wwf         , Ww          , Mm          , Ww          , Hh          , Gs^Ft       , Gs^Ft       , Gg          , Gg          , Wwf         , Gs^Ft       , Gs^Ft       , Gs^Ft       , Gs^Ft       , Ss          , Ww          , Wo          , Wo          , Wo          , Wo          , Wo          , Wo          , Wo          , Wo          , Wo          , Wo          , Ww          , Ww          , Ww          , Wo          , Wo          , Wo          , Wo          , Wo          , Ww          , Ww          , Ww          , Wo          , Ww          , Ww          , Ww          , Ww          
Ww^Bh\      , Ww          , Hh^Vhh      , Mm          , Mm          , Mm          , Re          , Hh          , Gs^Ft       , Gg          , Gs^Ft       , Gg          , Gg          , Gs^Ft       , Gs^Ft       , Gs^Ft       , Ss          , Ww          , Ww          , Wo          , Wo          , Wo          , Ww          , Wo          , Ss          , Ss          , Ss          , Ww          , Gg          , Gg          , Gg          , Gg          , Gg^Efm      , Wo          , Gs^Ft       , Gg          , Gg          , Hh^Ft       , Hh^Ft       , Ww          , Ww          , Gs^Fp       , Ds          , Ds          
Mm          , Re          , Re          , Hh          , Re          , Re          , Mm          , Re          , Re          , Gg          , Re          , Re          , Gg          , Gs^Ft       , Gs^Ft       , Gs^Ft       , Ss          , Ss          , Ww          , Ww          , Ww          , Ww          , Ww          , Ww          , Ww          , Ss^Vhs      , Ww^Bw\      , Ww          , Gg          , Gg^Efm      , Gg          , Gg          , Gg          , Wo          , Ss          , Gg          , Gs^Ft       , Hh^Ft       , Hh^Ft       , Dd          , Mm          , Hh          , Gs^Fp       , Hh^Fdw      
Mm          , Mm          , Mm          , Re          , Mm          , Mm          , Mm          , Hh          , Hh          , Re          , Re          , Gs^Ft       , Gg          , Gs^Ft       , Gs^Ft       , Gs^Ft       , Ss          , Ss          , Ss          , Ww          , Gs^Vl       , Gs          , Gs          , Ww          , Hh          , Ww          , Gs^Ft       , Gg          , Gg^Gvs      , Gg^Gvs      , Gg^Gvs      , Gg^Gvs      , Wo          , Wo          , Ss          , Gs^Ft       , Gg          , Hh^Ft       , Hh^Ft       , Hh          , Mm^Xm       , Hh          , Gg          , Hh^Fp       
Mm          , Mm          , Mm          , Mm          , Mm          , Mm          , Mm          , Hh          , Hh^Fds      , Gs^Fds      , Re          , Gg          , Gg          , Gg          , Gg          , Gs^Ft       , Sm          , Ww          , Ww          , Sm          , Mm          , Gs          , Hh          , Ww          , Hh          , Hh^Ft       , Hh^Ft       , Gs^Ft       , Gg          , Gg^Gvs      , Gg          , Gg          , Wo          , Wo          , Wo          , Ss          , Ss          , Gg^Vht      , Hh^Ft       , Hh          , Mm^Xm       , Mm          , Hh^Fp       , Hh^Fp       
Mm          , Mm          , Mm          , Mm          , Mm          , Mm          , Mm          , Hh          , Gs^Fds      , Gs^Fds      , Re          , Gg          , Gg          , Gs^Ft       , Gg          , Ss          , Ww          , Ww          , Ww          , Gs          , Mm          , Mm          , Mm          , Hh          , Mm          , Hh          , Hh          , Hh^Ft       , Gg          , Gg          , Wo          , Wo^Bw\      , Ch          , Ch          , Chs         , Wwr         , Gs^Ft       , Gs^Ft       , Hh          , Hh          , Wo          , Gs^Fp       , Ss          , Hh          
Mm          , Mm          , Mm          , Mm          , Mm          , Mm          , Mm          , Gs^Fds      , Gs^Fds      , Gs^Fds      , Gg^Ve       , Re          , Gg          , Gg          , Gg          , Gg          , Ww          , Ww          , Mm          , Mm          , Mm          , Mm          , Mm          , Mm          , Mm          , Mm          , Hh          , Hh^Ft       , Hh          , Wo          , Gg          , Wo          , Ch          , 1 Khw       , Chw         , Wo          , Wo          , Ss          , Wo          , Wo          , Wo          , Wo          , Ss          , Ss          
Mm          , Mm          , Mm          , Mm          , Mm          , Mm          , Mm          , Gs^Fds      , Gs^Fds      , Gs^Fds      , Re          , Re          , Re          , Gg          , Re          , Gg          , Wwf         , Wwf         , Re          , Hh          , Re          , Mm          , Mm          , Mm          , Hh          , Hh          , Hh          , Hh          , Wwf         , Wwr         , Gg          , Wo          , Wo          , Wo          , Wo          , Wo          , Hh          , Wo          , Hh          , Wo          , Wo          , Wo          , Wwf         , Gs^Fp       
Mm          , Mm          , Mm          , Mm          , Mm          , Mm          , Mm          , Hh          , Hh          , Hh^Fds      , Re          , Gg          , Gg          , Re          , Gg          , Re          , Re          , Wwf^Bw/     , Wwf         , Re          , Mm          , Ww^Bw\      , Re          , Re          , Wwf^Bw\     , Ww          , Ww          , Hh          , Ww          , Gg          , Hh          , Gg          , Gg          , Gg          , Gg          , Hh          , Hh^Fp       , Hh          , Wwr         , Wo          , Chs         , Wo          , Wo          , Ss          
Mm          , Mm          , Mm          , Mm          , Mm          , Mm          , Hh          , Hh          , Hh^Fds      , Ch          , Ch          , Ch          , Gg          , Gg          , Gg          , Gg          , Ww          , Ww          , Wo          , Ww          , Mm          , Mm          , Ww          , Ww          , Ww          , Ww^Bw\      , Hh^Vhh      , Wwf^Fp      , Hh          , Hh          , Hh          , Hh          , Gg          , Gg          , Gg          , Gs^Fp       , Gs^Fp       , Ww          , Ww          , Chw         , Khw         , Wwf         , Wwf         , Gg          
Mm          , Mm          , Mm          , Mm          , Mm          , Mm          , Hh          , Hh^Fds      , Hh^Fds      , Ch          , 2 Kh        , Ch          , Gg          , Gg          , Gg          , Hh^Ft       , Ww^Ft       , Wo          , Wo          , Wo          , Wo          , Wwf         , Wo          , Wo          , Wo          , Ww          , Mm          , Hh          , Hh^Fp       , Hh          , Hh          , Hh^Fp       , Hh^Fp       , Gs^Fp       , Gg          , Gg          , Gs^Fp       , Ww          , Ww          , Chw         , Chw         , Wwf         , Ww          , Gg          
Mm          , Mm          , Mm          , Mm          , Mm          , Mm          , Hh          , Hh^Fds      , Hh^Fds      , Ch          , Ch          , Gg          , Gg          , Gg          , Gg          , Hh^Fds      , Hh^Ft       , Ww^Ft       , Wo          , Wo          , Wo          , Wo          , Wo          , Wo          , Wo          , Ww          , Mm          , Mm          , Ww^Fp       , Hh          , Hh          , Hh          , Hh          , Hh^Fp       , Gs^Fp       , Gg          , Gg          , Ww          , Ww          , Ww          , Ww          , Ww          , Gg          , Gg          
Mm          , Mm          , Mm          , Mm          , Mm^Vhh      , Mm          , Hh          , Hh^Fds      , Hh^Fds      , Hh^Fds      , Re          , Gg          , Gg          , Gg          , Gg          , Hh^Fds      , Mm          , Wo^Ft       , Mm^Ft       , Wo          , Wo          , Wo          , Wo          , Wo          , Ww          , Ww          , Wwf^Ft      , Ww          , Ww          , Ww          , Hh          , Hh          , Hh          , Hh^Fp       , Gs^Fp       , Gg          , Gg          , Gg          , Gg          , Gg          , Gg          , Ww          , Gg          , Gg          
Mm          , Mm          , Mm          , Mm          , Mm          , Re          , Hh          , Hh^Fds      , Gs^Fds      , Gg          , Re          , Gg          , Gg          , Gg          , Gg          , Gg          , Wo          , Wo^Ft       , Wo^Ft       , Wo^Ft       , Mm^Ft       , Wo          , Wo^Ft       , Wo^Ft       , Hh^Ft       , Mm^Ft       , Mm^Ft       , Wwf^Ft      , Ww          , Ww          , Ww          , Hh          , Ww          , Hh          , Hh^Efm      , Gg^Efm      , Gg          , Gg          , Gg          , Gg          , Gg          , Gg          , Gg          , Ww          
Ww          , Ww^Es       , Wwf         , Hh          , Hh          , Re          , Hh          , Gs^Fds      , Re          , Re          , Hh^Fds      , Hh          , Gg          , Gg          , Gg          , Ds          , Wo          , Wo          , Wo^Ft       , Wo^Ft       , Wo^Ft       , Wo^Ft       , Mm^Ft       , Wo^Ft       , Mm          , Mm          , Mm^Ft       , Wwf         , Ww          , Ww          , Ww          , Ww          , Ww          , Hh^Ve       , Hh          , Hh^Efm      , Gg          , Gg          , Gg          , Gg          , Gg          , Gg          , Gs^Fp       , Ww          
Mm          , Ww          , Ww          , Wwf         , Hh          , Re          , Re          , Re          , Hh^Fds      , Hh^Fds      , Hh^Fds      , Hh          , Hh          , Hh          , Ds          , Ds          , Wwf^Bw\     , Wo          , Wwf^Ft      , Wwf^Ft      , Mm^Ft       , Mm^Ft       , Mm          , Mm          , Mm          , Mm          , Mm          , Wwf         , Wwf         , Wwf         , Ww          , Ww          , Hh^Fp       , Hh^Fp       , Hh          , Hh          , Gg          , Gg          , Ww          , Gg          , Gg          , Gg          , Ww          , Ww          
