border_size=1
usage=map

Md          , Md          , Md          , Md          , Md          , Md          , Mm          , Hd          , Hd          , Rd          , Hhd         , Md          , Md          , Md          , Md          , Md          , Mm          , Mm          , Mm          , Mm          , Mm          , Mm          , Mm          , Mm          , Mm          , Ww          , Mm          , Mm          , Mm          , Ww          , Mm          , Mm          , Mm          , Mm          , Mm          , Mm          , Mm          , Mm          , Mm          , Mm          , Mm          , Mm          , Mm          , Mm          , Hh          , Hh^Fds      , Hh^Fds      , Hh^Fds      , Hh^Fds      , Hh          , Hh          , Hh          , Hh          , Ww^Bw\      , Ww^Bw\      
Md          , Md          , Md          , Md          , Md          , Mm          , Mm^Xm       , Mm          , Hhd         , Rd          , Hhd         , Md          , Dd          , Dd^Vct      , Md          , Md          , Mm          , Mm          , Mm          , Mm          , Mm          , Mm          , Mm          , Mm          , Ww          , Ww          , Mm^Xm       , Mm^Xm       , Mm          , Mm          , Mm          , Mm          , Mm          , Mm          , Ww          , Ww          , Ww          , Mm          , Mm          , Mm          , Mm          , Mm          , Mm          , Mm          , Mm          , Hh^Fds      , Hh^Fds      , Hh^Fds      , Hh          , Hh          , Hh          , Hh          , Hh          , Ww          , Mm^Vhh      
Md^Xm       , Md          , Md^Xm       , Md^Xm       , Md^Xm       , Mm^Xm       , Mm^Xm       , Mm          , Hhd^Vhh     , Rd          , Rd          , Dd          , Dd          , Dd          , Hd^Es       , Md          , Mm          , Mm          , Mm          , Mm          , Mm          , Mm          , Mm          , Mm          , Mm          , Ww          , Mm          , Mm^Xm       , Mm^Xm       , Mm          , Mm          , Mm          , Mm          , Mm          , Mm^Xm       , Ww          , Ww          , Mm          , Mm          , Mm          , Mm          , Mm          , Mm          , Mm          , Mm          , Mm          , Mm          , Hh^Fds      , Hh          , Hh          , Hh          , Hh          , Hh          , Mm          , Mm          
Md^Xm       , Md^Xm       , Md^Xm       , Mm          , Mm          , Mm          , Mm          , Mm          , Mm          , Hhd         , Rd          , Hd          , Hd          , Hd          , Hd^Es       , Md          , Mm          , Mm          , Mm          , Mm          , Mm          , Mm          , Mm          , Mm          , Mm          , Mm          , Mm          , Mm          , Mm          , Mm          , Mm          , Mm          , Mm          , Mm          , Ww          , Ww          , Wo          , Ww          , Mm          , Mm          , Ww          , Mm          , Mm          , Mm          , Mm          , Mm          , Mm          , Mm          , Mm          , Mm          , Hh          , Mm          , Mm          , Mm          , Mm          
Mm          , Mm          , Mm          , Mm          , Mm^Xm       , Mm          , Mm^Xm       , Mm          , Mm          , Mm          , Rd          , Hd          , Hd          , Hd          , Md          , Md          , Mm          , Mm          , Mm          , Mm          , Mm          , Mm          , Mm          , Mm          , Mm          , Mm          , Mm          , Mm          , Ww          , Mm          , Mm          , Mm          , Mm          , Ww          , Ww          , Wo          , Wo          , Ww          , Ww          , Mm          , Ww          , Ww          , Ww          , Mm          , Ww          , Mm          , Mm          , Mm          , Mm          , Mm          , Mm          , Mm          , Ww          , Ww          , Ww          
Mm          , Mm          , Mm          , Mm          , Mm          , Mm^Xm       , Mm          , Mm^Xm       , Mm          , Ch          , Rd          , Rd          , Rd          , Dd^Es       , Md          , Mm          , Mm          , Mm          , Mm          , Mm          , Mm          , Mm          , Mm          , Mm          , Mm          , Mm          , Mm          , Mm          , Ww          , Ww          , Mm          , Mm          , Mm          , Mm          , Ww          , Wo          , Ww          , Ww          , Wwf         , Ww          , Mm          , Mm          , Mm          , Ww          , Ww          , Mm          , Mm          , Mm          , Mm          , Mm          , Wwf         , Ww          , Mm          , Mm          , Ww          
Mm          , Mm          , Mm          , Mm          , Mm          , Mm          , Mm          , Mm          , Rd          , Rd          , Mm          , Ch          , Mm          , Dd          , Md          , Mm          , Mm          , Mm          , Mm          , Mm          , Mm          , Mm          , Mm          , Mm          , Wo          , Wo          , Wwf         , Ww          , Mm          , Wo          , Wo          , Mm          , Mm          , Mm^Xm       , Mm^Xm       , Ww          , Mm          , Mm          , Ww          , Mm          , Mm          , Mm          , Mm          , Mm^Ftp      , Ww          , Mm          , Mm          , Mm          , Mm          , Mm          , Ww          , Mm          , Mm          , Ww          , Ww          
Mm          , Mm          , Mm          , Mm          , Mm^Xm       , Mm^Xm       , Mm          , Mm          , Rd          , Mm          , Mm          , Mm          , Mm          , Mm          , Mm          , Mm          , Mm          , Mm          , Ww          , Mm          , Mm          , Mm          , Mm          , Mm          , Wo          , Wo          , Mm          , Ww          , Mm          , Wo          , Wo          , Wo          , Mm          , Mm          , Ww          , Mm          , Mm          , Mm          , Mm          , Mm          , Mm          , Mm          , Mm^Ftp      , Mm^Ftp      , Ww          , Hh^Vhh      , Mm          , Mm          , Ww          , Ww          , Mm^Xm       , Ww          , Ww          , Ww          , Ww          
Mm          , Mm          , Mm^Xm       , Mm^Xm       , Mm          , Mm          , Mm          , Mm          , Rd          , Mm^Xm       , Mm          , Mm          , Mm^Xm       , Mm^Xm       , Mm          , Mm          , Ww          , Ww          , Mm          , Ww          , Mm          , Mm          , Mm          , Mm          , Wo          , Wo          , Mm          , Mm          , Mm          , Mm          , Mm          , Wo          , Ww          , Mm          , Ww          , Ww          , Mm          , Mm          , Mm          , Mm          , Ww          , Mm^Ftp      , Ww^Ftp      , Hh^Ftp      , Wo^Ftp      , Ww          , Ww          , Mm          , Ww          , Mm          , Mm^Xm       , Ww          , Mm          , Ww          , Ww          
Mm          , Mm^Xm       , Mm          , Mm^Xm       , Mm          , Mm          , Dd^Es       , Dd          , Md^Xm       , Mm          , Mm          , Mm          , Mm          , Mm          , Mm          , Mm          , Mm          , Mm          , Mm          , Mm          , Mm          , Mm          , Mm          , Mm          , Mm          , Wo          , Mm          , Mm          , Mm          , Mm          , Mm          , Mm          , Ww          , Ww          , Mm          , Ww          , Mm          , Mm          , Mm          , Ww          , Ww^Vm       , Ww          , Ww^Ftp      , Ww^Ftp      , Mm^Ftp      , Mm^Ftp      , Mm^Ftp      , Ww          , Mm          , Mm          , Mm          , Mm          , Mm          , Mm          , Mm          
Mm          , Mm          , Mm          , Mm          , Mm          , Hd^Eff      , Hd^Eff      , Md          , Mm^Xm       , Mm^Xm       , Mm          , Mm          , Mm          , Mm          , Mm          , Mm          , Mm          , Mm          , Mm          , Mm          , Mm          , Mm          , Mm          , Mm          , Mm          , Wo          , Mm          , Mm          , Mm          , Mm          , Mm          , Mm          , Ww          , Ww          , Mm          , Ww          , Mm          , Mm          , Ww          , Ww          , Wo          , Ww          , Mm^Ftp      , Mm^Ftp      , Mm          , Mm          , Mm          , Mm          , Mm          , Mm          , Mm          , Mm          , Ww          , Mm^Xm       , Ww          
Hh^Ftp      , Hh^Ftp      , Hh^Ftp      , Mm          , Hh^Ft       , Hd^Es       , Hd^Es       , Md          , Mm          , Mm          , Mm          , Mm          , Mm          , Mm          , Mm          , Mm          , Mm          , Mm          , Mm          , Mm          , Mm          , Mm          , Mm          , Mm          , Mm          , Mm          , Mm          , Mm          , Mm          , Mm          , Mm          , Mm          , Mm          , Mm          , Mm          , Ww          , Mm          , Ww          , Wo          , Wo          , Wo          , Ww          , Mm          , Mm          , Mm          , Mm          , Mm          , Mm          , Mm          , Mm          , Mm          , Ww          , Ww          , Ww          , Wo          
Hh^Ftp      , Hh^Ftp      , Hh^Ftp      , Hh^Ftp      , Hh^Ft       , Hh^Ft       , Hh^Ft       , Hh^Ft       , Mm          , Mm          , Mm          , Mm          , Mm          , Mm^Xm       , Mm          , Mm          , Mm          , Mm          , Ww          , Mm          , Mm          , Mm          , Mm          , Mm          , Mm          , Mm          , Mm          , Mm          , Mm          , Mm          , Mm          , Mm          , Mm          , Mm          , Mm          , Ww          , Ww          , Ww          , Ww          , Wo          , Ww          , Ww          , Ww          , Ww          , Mm          , Mm          , Mm          , Mm          , Mm          , Mm          , Mm          , Mm          , Mm          , Wo          , Wo          
Hh^Ftp      , Hh^Ftp      , Hh^Ftp      , Hh^Ftp      , Mm          , Hh^Ft       , Hh^Ft       , Mm          , Mm          , Mm          , Mm          , Mm          , Mm          , Mm          , Mm          , Mm^Xm       , Mm          , Mm          , Mm          , Ww          , Mm          , Mm          , Mm          , Mm          , Mm          , Mm          , Mm          , Mm          , Mm          , Mm          , Ww          , Ww          , Ww          , Mm          , Mm          , Mm          , Mm          , Mm          , Ww          , Mm^Ftp      , Ww^Ftp      , Mm^Ftp      , Ww          , Mm          , Mm          , Mm          , Mm          , Mm          , Mm          , Mm          , Mm          , Mm          , Mm          , Mm          , Ww          
Mm          , Hh^Ftp      , Mm          , Mm          , Mm          , Hh^Ft       , Mm          , Mm          , Mm          , Mm          , Mm          , Mm          , Mm          , Mm          , Mm          , Mm          , Mm          , Mm          , Mm          , Mm          , Mm          , Mm          , Mm          , Mm          , Wo          , Wo          , Mm          , Mm          , Mm          , Mm          , Mm          , Ww          , Wo          , Ww          , Mm          , Mm          , Mm          , Mm          , Mm          , Mm          , Mm^Ftp      , Mm^Ftp      , Wwf         , Ww          , Ww          , Mm          , Mm          , Mm          , Mm          , Mm          , Mm          , Mm          , Mm          , Mm          , Mm          
Hh^Ft       , Mm          , Mm          , Hh^Ftr      , Hh^Ftr      , Mm          , Mm          , Mm          , Mm          , Mm          , Mm          , Mm          , Mm          , Mm          , Mm          , Mm          , Mm          , Mm          , Wo          , Mm          , Mm          , Mm          , Mm          , Mm          , Wo          , Wo          , Mm          , Mm          , Ww          , Ww          , Ww          , Ww          , Wo          , Ww          , Mm          , Mm          , Mm          , Mm          , Mm          , Mm          , Mm          , Mm^Ftp      , Mm          , Wo          , Wo          , Ww          , Ww          , Mm          , Mm          , Mm          , Mm          , Mm          , Mm          , Mm          , Mm          
Hh^Ft       , Hh^Ft       , Hh^Ft       , Hh^Ftr      , Hh^Ftr      , Hh^Ftr      , Hh^Ftr      , Mm          , Hh^Vo       , Mm          , Mm          , Mm          , Mm          , Mm          , Mm          , Mm          , Wo          , Wo          , Wo          , Mm          , Mm          , Mm          , Mm          , Mm^Xm       , Wo          , Wo          , Mm          , Mm          , Mm          , Ww          , Ww^Vm       , Wo          , Wo          , Ww          , Ww          , Mm          , Mm          , Mm          , Mm          , Mm          , Mm          , Mm          , Ww          , Mm          , Mm          , Wo          , Ww          , Mm          , Wwf         , Mm          , Mm          , Mm          , Mm          , Mm          , Mm          
Gs^Ft       , Gs^Ft       , Gs^Ft       , Gs^Ft       , Gs^Ft       , Gs^Ftr      , Hh^Ftr      , Hh^Ftr      , Mm          , Mm          , Mm          , Mm          , Mm          , Mm^Xm       , Mm^Xm       , Mm^Xm       , Mm          , Wo          , Wo          , Wo          , Wo          , Mm          , Mm          , Mm^Xm       , Mm^Xm       , Wo          , Mm          , Mm          , Mm          , Ww          , Ww          , Wo          , Wo          , Wo          , Ww          , Mm          , Ww          , Ww          , Ww          , Mm          , Mm          , Mm          , Ww          , Ww          , Mm          , Wo          , Mm          , Ww          , Ww          , Mm          , Mm          , Mm          , Mm          , Mm          , Mm          
Gs^Ft       , Gs^Ft       , Gs^Ft       , Gs^Ft       , Gs^Ft       , Gs^Ftr      , Hh^Ftr      , Hh^Ftr      , Mm          , Mm          , Mm          , Mm          , Mm          , Mm          , Mm          , Mm          , Mm          , Mm          , Mm          , Wo          , Wo          , Wo          , Mm          , Mm          , Mm          , Wo          , Mm^Xm       , Mm          , Mm          , Mm          , Ww          , Wo          , Wo          , Wo          , Wo          , Ww          , Mm          , Mm^Vhh      , Mm          , Ww          , Ww          , Ww          , Khr         , Ww          , Mm          , Wo          , Mm          , Mm          , Ww          , Mm          , Mm          , Mm          , Mm          , Mm          , Mm          
Gs^Ft       , Gs^Ft       , Gs^Ft       , Gs^Ft       , Gs^Ft       , Gs^Ft       , Hh^Ftr      , Hh^Ftr      , Mm          , Mm          , Mm          , Mm          , Mm          , Mm          , Mm          , Mm          , Mm          , Mm          , Mm          , Wo          , Mm          , Mm          , Mm          , Mm          , Mm          , Mm          , Mm          , Wo          , Wo          , Wo          , Wo          , Wo          , Wo          , Wo          , Wo          , Wo          , Wo          , Wo          , Wo          , Wwf         , Ww          , Ww          , Ww          , Wwf         , Wo          , Wo          , Wo          , Wo          , Wo          , Wo          , Wo          , Wo          , Mm          , Mm          , Mm          
Gs^Ft       , Gs^Ft       , Gs^Ft       , Gs^Ft       , Hh^Ft       , Hh^Ft       , Mm          , Mm          , Mm          , Mm          , Mm          , Mm          , Mm          , Mm          , Mm          , Mm          , Mm          , Mm          , Mm          , Mm          , Mm          , Mm          , Mm          , Mm          , Mm          , Mm          , Mm^Xm       , Mm          , Mm          , Wo          , Wo          , Wo          , Wo          , Wo          , Wo          , Wo          , Wo          , Wo          , Wo          , Wo          , Wo          , Ww          , Wo          , Wo          , Wo          , Wo          , Wo          , Wo          , Wo          , Wo          , Wo          , Wo          , Mm          , Mm          , Mm          
Gs^Eff      , Gs^Eff      , Dd^Vdt      , Hh^Ft       , Mm          , Mm          , Mm          , Mm          , Mm          , Mm          , Hh^Ft       , Hh^Ft       , Mm          , Mm          , Mm          , Mm          , Mm          , Mm          , Mm^Xm       , Mm^Xm       , Mm          , Mm          , Mm          , Mm          , Mm          , Mm          , Mm^Xm       , Mm^Xm       , Mm^Xm       , Mm^Xm       , Mm          , Wo          , Mm          , Wo          , Wo          , Wo          , Kh          , Wo          , Wo          , Wo          , Wo          , Wo          , Wo          , Wo          , Wo          , Wo          , Wo          , Wo          , Wo          , Wo          , Mm          , Wo          , Mm          , Mm          , Mm          
Gs          , Dd          , Hd          , Mm          , Mm          , Mm          , Ww          , Wwf         ,           Ce, Ke          , Ce          , Gg^Ve       , Gs          , Mm          , Hh          , Mm          , Mm          , Mm          , Mm          , Mm^Xm       , Mm^Xm       , Mm          , Mm          , Mm          , Mm^Xm       , Mm^Xm       , Mm          , Mm          , Wo          , Mm          , Mm          , Mm          , Mm          , Mm          , Mm          , Wo          , Wo          , Wo          , Wo          , Wo          , Wo          , Wo          , Wo          , Wo          , Hh^Vc       , Chw         , Khr         , Wo          , Wo          , Mm          , Mm          , Mm          , Mm          , Mm          , Mm          
Wo          , Dd          , Wo          , Mm          , Wo          , Wo          , Hh          , Hh          ,           Ce,           Ce, Gs          , Hh^Ft       , Hh          , Hh          , Mm          , Mm          , Mm          , Mm          , Mm^Xm       , Mm          , Mm^Xm       , Mm          , Mm^Xm       , Wo          , Wo          , Mm          , Mm          , Mm          , Mm          , Mm          , Mm          , Mm          , Mm          , Mm          , Wo          , Wo          , Mm          , Wo          , Mm          , Wo          , Wo          , Wo          , Mm          , Mm          , Mm          , Mm          , Mm          , Mm          , Wo          , Mm          , Mm          , Mm          , Mm          , Mm          , Mm          
Gs^Ft       , Wo          , Wo          , Wo          , Hh^Ft       , Hh^Ft       , Hh          , Hh          , Hh^Ft       , Hh^Ft       , Gs          , Hh^Ft       , Hh          , Hh^Ft       , Mm          , Mm          , Mm^Xm       , Mm^Xm       , Mm          , Mm          , Mm          , Mm^Xm       , Wo          , Mm          , Wo          , Mm          , Mm          , Mm          , Mm          , Mm          , Mm          , Mm          , Wo          , Wo          , Mm          , Mm          , Mm          , Mm          , Mm          , Mm          , Mm          , Mm          , Mm          , Mm          , Mm          , Mm          , Mm          , Mm          , Wo          , Mm          , Mm          , Mm          , Mm          , Mm          , Mm          
Mm          , Dd          , Gs^Ft       , Wo          , Wo          , Hh^Ft       , Hh          , Hh          , Gs          , Gs          , Hh^Ft       , Hh^Ft       , Hh^Ft       , Ww          , Ww          , Ww          , Mm          , Wo          , Mm          , Mm          , Mm          , Mm          , Wo          , Wo          , Mm          , Wo          , Wo          , Mm          , Mm          , Mm          , Mm          , Wo          , Mm          , Mm          , Mm          , Mm          , Mm          , Mm          , Mm          , Mm          , Mm          , Mm          , Mm          , Mm          , Mm          , Mm          , Wo          , Mm          , Mm          , Wo          , Mm          , Mm          , Mm          , Mm          , Mm          
Mm          , Mm          , Mm          , Wwf         , Wo          , Wo          , Hh^Ft       , Hh          , Wo          , Wo          , Wo          , Wo          , Wwf         , Ww          , Wwf         , Mm          , Mm          , Mm^Xm       , Mm          , Mm          , Mm          , Wo          , Wo          , Mm          , Mm          , Mm          , Mm          , Wo          , Wo          , Mm          , Mm          , Wo          , Mm          , Mm          , Mm          , Mm          , Mm          , Mm          , Mm          , Mm          , Mm          , Mm          , Mm          , Mm          , Mm          , Mm          , Mm          , Wo          , Wo          , Wo          , Wo          , Mm          , Mm          , Mm          , Mm          
Ww          , Mm          , Gs          , Mm^Xm       , Mm          , Wo          , Wo          , Wo          , Mm          , Mm          , Mm          , Mm          , Wwf         , Wwf         , Mm          , Mm          , Mm          , Mm          , Mm          , Mm          , Mm          , Mm          , Mm          , Wo          , Wwf         , Mm          , Mm          , Mm          , Wo          , Wo          , Wo          , Wo          , Mm          , Mm          , Mm          , Mm          , Mm          , Mm          , Mm          , Wo          , Wo          , Mm          , Mm          , Mm          , Mm          , Mm          , Wo          , Mm          , Mm          , Mm          , Mm          , Wo          , Wo          , Wo          , Wo          
Gs          , Ww          , Ww          , Mm          , Mm^Xm       , Mm          , Mm          , Mm          , Mm          , Mm          , Gs          , Wwf         , Gs          , Wwf         , Mm          , Mm^Xm       , Mm^Xm       , Mm          , Mm          , Mm          , Mm          , Mm          , Mm          , Mm          , Mm          , Mm          , Mm          , Mm          , Mm          , Mm          , Mm          , Wo          , Mm          , Mm          , Mm          , Mm          , Mm          , Mm          , Mm          , Mm          , Mm          , Mm          , Mm          , Mm          , Mm          , Mm          , Mm          , Wo          , Mm          , Mm          , Mm          , Wo          , Wo          , Wo          , Wo          
Mm          , Mm          , Mm          , Ww          , Mm^Xm       , Mm          , Mm^Xm       , Mm          , Mm          , Hh          , Hh          , Gs          , Hh          , Hh          , Mm          , Mm          , Mm^Xm       , Mm          , Mm          , Mm          , Mm          , Wo          , Mm          , Mm          , Mm          , Mm          , Mm          , Mm          , Wo          , Wo          , Wo          , Wo          , Wo          , Wo          , Wo          , Mm          , Mm          , Mm          , Mm          , Mm          , Mm          , Mm          , Wo          , Mm          , Mm          , Mm          , Mm          , Mm          , Mm          , Mm          , Wo          , Wo          , Wo          , Wo          , Wo          
Mm          , Mm          , Mm          , Ww          , Wwf         , Mm^Xm       , Mm^Xm       , Mm          , Mm^Xm       , Mm          , Mm          , Hh          , Mm          , Mm          , Mm^Xm       , Mm^Xm       , Mm          , Mm^Xm       , Mm^Xm       , Mm          , Mm          , Mm          , Mm          , Mm          , Mm          , Mm          , Wo          , Wo          , Wo          , Wo          , Co          , Ss          , Co          , Wo          , Wo          , Ss          , Ss          , Mm          , Mm          , Mm          , Mm          , Mm          , Mm          , Wo          , Wo          , Mm          , Mm          , Mm          , Wo          , Wo          , Mm          , Mm          , Mm          , Wo          , Wo          
Mm^Xm       , Mm^Xm       , Mm^Xm       , Mm          , Mm          , Wwf         , Mm          , Mm^Xm       , Mm          , Mm^Xm       , Mm^Xm       , Mm          , Mm^Xm       , Mm^Xm       , Mm^Vc       , Mm          , Mm          , Mm          , Mm^Xm       , Mm^Xm       , Mm          , Mm          , Mm          , Mm          , Mm          , Wo          , Wo          , Wo          , Wo          , Wo          , Ss          , Ko          , Rr^Vd       , Wo          , Wo          , Wo          , Wo          , Wwf         , Mm          , Mm          , Mm          , Mm          , Mm          , Mm          , Mm          , Wo          , Mm          , Mm          , Wo          , Mm          , Mm          , Mm          , Mm          , Mm          , Mm          
Mm          , Wo          , Mm          , Mm^Xm       , Mm^Xm       , Mm          , Mm          , Mm          , Wwf         , Mm^Xm       , Mm          , Mm^Xm       , Mm^Xm       , Mm          , Mm          , Mm          , Mm          , Mm          , Mm          , Mm^Xm       , Mm^Xm       , Mm          , Mm          , Mm          , Mm          , Wo          , Wo          , Wo          , Wo          , Wo          , Ww          , Ww          , Ww          , Wo          , Wo          , Wo          , Wo          , Wo          , Mm          , Mm          , Mm          , Mm          , Mm          , Mm          , Mm          , Mm          , Mm          , Mm          , Mm          , Wo          , Wo          , Wo          , Wo          , Wo          , Mm          
Mm          , Wwf         , Wo          , Mm          , Mm          , Mm^Xm       , Mm          , Mm          , Wo          , Mm          , Mm^Xm       , Mm^Xm       , Mm          , Mm          , Mm          , Mm          , Mm          , Mm          , Mm          , Mm          , Mm^Xm       , Mm          , Mm^Xm       , Mm          , Wo          , Wo          , Wo          , Wo          , Wo          , Wo          , Ww          , Ww^Fet      , Ww          , Wo          , Wo          , Wo          , Wo          , Wo          , Wo          , Mm          , Mm          , Mm          , Mm          , Mm          , Mm          , Mm          , Mm          , Mm          , Mm          , Mm          , Wo          , Wo          , Mm          , Wo          , Wo          
Mm          , Wo          , Mm          , Mm          , Mm          , Mm^Xm       , Mm^Xm       , Mm          , Mm          , Wo          , Wo          , Mm          , Mm          , Mm          , Mm          , Mm^Xm       , Mm^Xm       , Mm          , Mm          , Mm          , Mm^Xm       , Mm^Xm       , Mm          , Wo          , Wo          , Wo          , Wo          , Ww^Vm       , Ww          , Ww          , Ww          , Ww^Bw|r     , Ww          , Ww          , Ww          , Ww^Vm       , Wo          , Wo          , Wo          , Wo          , Mm          , Mm          , Mm          , Wo          , Wo          , Mm          , Mm          , Mm          , Mm          , Mm          , Wo          , Wo          , Wo          , Wo          , Mm          
Mm          , Mm          , Mm^Xm       , Mm          , Mm          , Mm          , Mm          , Mm          , Mm          , Wo          , Wo          , Mm          , Mm          , Mm          , Mm          , Mm          , Mm^Xm       , Mm^Xm       , Mm^Xm       , Mm^Xm       , Mm          , Mm          , Mm          , Wo          , Wo          , Wo          , Wo          , Wo          , Ww          , Ww          , Chw         , Chw         , Chw         , Ww          , Ww          , Wo          , Wo          , Wo          , Wo          , Wo          , Mm          , Mm          , Mm          , Wo          , Wo          , Wo          , Mm          , Mm          , Mm          , Mm          , Mm          , Wo          , Mm          , Wo          , Mm          
