border_size=1
usage=map

Xuc         , Xu          , Xuc         , Xuc         , Ur          , Xu          , Xu          , Hd          , Hd          , Rd          , Hhd         , Md          , Md          , Md          , Md          , Xu          , Uu          , Uu          , Xu          , Uu          , Uu          , Uu          , Uu          , Xu          , Xu          , Ww          , Mm          , Mm          , Mm          , Ww          , Mm          , Mm          , Mm          , Mm          , Mm          , Mm          , Mm          , Mm          , Mm          , Mm          , Mm          , Mm          , Mm          , Mm          , Hh          , Hh^Fds      , Hh^Fds      , Hh^Fds      , Hh^Fds      , Hh          , Hh          , Hh          , Hh          , Ww^Bw\      , Ww^Bw\      
Xuc         , Xuc         , Ur          , Ur          , Ur          , Ur          , Ur^Vud      , Xu          , Hhd         , Rd          , Hhd         , Md          , Dd          , Dd^Vct      , Md          , Xu          , Xu          , Uu          , Uu          , Uu          , Xu          , Xu          , Uu^Uf       , Uu^Ufi      , Ww          , Ww          , Mm^Xm       , Mm^Xm       , Mm          , Mm          , Mm          , Mm          , Mm          , Mm          , Ww          , Ww          , Ww          , Mm          , Mm          , Mm          , Mm          , Mm          , Mm          , Mm          , Mm          , Hh^Fds      , Hh^Fds      , Hh^Fds      , Hh          , Hh          , Hh          , Hh          , Hh          , Ww          , Mm^Vhh      
Ur          , Ur          , Ur          , Ur          , Xu          , Xu          , Xu          , Xu          , Hhd^Vhh     , Rd          , Rd          , Dd          , Dd          , Dd          , Hd^Es       , Md          , Xu          , Xu          , Xu          , Xu          , Xu          , Xu          , Xu          , Xu          , Xu          , Ww          , Xu          , Xu          , Uu          , Xu          , Xu          , Xu          , Xu          , Xu          , Xu          , Ww          , Ww          , Mm          , Mm          , Mm          , Mm          , Mm          , Mm          , Mm          , Mm          , Mm          , Mm          , Hh^Fds      , Hh          , Hh          , Hh          , Hh          , Hh          , Mm          , Mm          
Ur          , Ur          , Ur          , Uu^Emf      , Uh^Emf      , Xu          , Xu          , Xuc         , Xuc         , Hhd         , Rd          , Hd          , Hd          , Hd          , Hd^Es       , Md          , Xu          , Uu^Vu       , Uu          , Uu          , Uu          , Uu          , Uu          , Xu          , Uh          , Xu          , Uu          , Uu          , Xu          , Uu          , Uh          , Uh          , Xu          , Xu          , Ww          , Ww          , Wo          , Ww          , Mm          , Mm          , Ww          , Mm          , Mm          , Mm          , Mm          , Mm          , Mm          , Mm          , Mm          , Mm          , Hh          , Mm          , Mm          , Mm          , Mm          
Xu          , Xu          , Xu          , Ur          , Ur          , Xuc         , Cud         , Kud         , Cud         , Xuc         , Rd          , Hd          , Hd          , Hd          , Md          , Md          , Xu          , Uu          , Uu          , Uu          , Xu          , Uu          , Uu          , Uu          , Uu          , Uu          , Uu^Vu       , Xu          , Ww          , Xu          , Xu          , Uu          , Xu          , Ww          , Ww          , Wo          , Wo          , Ww          , Ww          , Mm          , Ww          , Ww          , Ww          , Mm          , Ww          , Mm          , Mm          , Mm          , Mm          , Mm          , Mm          , Mm          , Ww          , Ww          , Ww          
Urb         , Urb         , Xu          , Xu          , Xu          , Ur          , Cud         , Xuc         , Xuc         , Ch          , Rd          , Rd          , Rd          , Dd^Es       , Md          , Xu          , Uu          , Uu          , Cud         , Cud         , Xu          , Xu          , Cud         , Uu          , Xu          , Xu          , Xu          , Xu          , Ww          , Ww          , Uu^Uf       , Uu          , Uu^Vu       , Xu          , Ww          , Wo          , Ww          , Ww          , Wwf         , Ww          , Xu          , Xu          , Xu          , Ww          , Ww          , Mm          , Mm          , Mm          , Mm          , Mm          , Wwf         , Ww          , Xu          , Xu          , Ww          
Xu          , Urb         , Xu          , Ur^Vud      , Ur          , Xuc         , Ur          , Xuc         , Rd          , Rd          , Mm          , Ch          , Mm          , Dd          , Md          , Xu          , Uu          , Uu          , Cud         , 5 Kud       , Cud         , Uu^Uf       , Uh^Emf      , Xu          , Wo          , Wo          , Wwf         , Ww          , Xu          , Wo          , Wo          , Xu          , Xu          , Xu          , Xu          , Ww          , Xu          , Xu          , Ww          , Xu          , Xu          , Xu          , Xu          , Xu          , Ww          , Mm          , Mm          , Mm          , Mm          , Mm          , Ww          , Xu          , Xu          , Ww          , Ww          
Xu          , Urb         , Xu          , Xu          , Ur          , Ur          , Ur          , Xu          , Rd          , Xu          , Xu          , Xu          , Xu          , Xu          , Xu          , Xu          , Uu          , Uu          , Xu          , Xu          , Ur          , Uh^Uf       , Uh^Emf      , Xu          , Wo          , Wo          , Xu          , Ww          , Xu          , Wo          , Wo          , Wo          , Xu          , Xu          , Ww          , Xu          , Xu          , Uu          , Xu          , Xu          , Xu          , Xu          , Uh          , Xu          , Ww          , Hh^Vhh      , Mm          , Mm          , Ww          , Ww          , Xu          , Ww          , Ww          , Ww          , Ww          
Uu^Vu       , Cud         , Uu          , Qxu         , Uu          , Xu          , Xu          , Xu          , Rd          , Xu          , Uu          , Uu          , Uu          , Uu          , Uu          , Uu          , Xu          , Xu          , Ur          , Ur          , Xu          , Xu          , Uh          , Xu          , Wo          , Wo          , Xu          , Xu          , Uu^Vud      , Xu          , Xu          , Wo          , Ww          , Xu          , Ww          , Ww          , Xu          , Cud         , Xu          , Xu          , Ww          , Xu          , Ww^Ftp      , Hh^Ftp      , Wo^Ftp      , Ww          , Ww          , Mm          , Ww          , Xu          , Xu          , Ww          , Xu          , Ww          , Ww          
Qxu         , Xu          , Uu^Emf      , Uu          , Xu          , Xu          , Dd^Es       , Dd          , Xu          , Xu          , Uu^Emf      , Uu          , Xu          , Xu          , Xu          , Uu^Vu       , Xu          , Ur          , Uu          , Uu^Vud      , Xu          , Qxu         , Qxu^Bs/     , Xu          , Xu          , Wo          , Xu          , Ww          , Ww          , Ww          , Chw         , Xu          , Ww          , Ww          , Xu          , Ww          , Xu          , Xu          , Xu          , Ww          , Ww^Vm       , Ww          , Ww^Ftp      , Ww^Ftp      , Xuc         , Xuc         , Xuc         , Ww          , Xu          , Uu^Uf       , Uu^Vud      , Xu          , Xuc         , Xu          , Xuc         
Xu          , Xu          , Xu          , Xu          , Xu          , Hd^Eff      , Hd^Eff      , Xu          , Xu          , Xu          , Uu^Uf       , Xu          , Cud         , 6 Kud       , Cud         , Xu          , Xu          , Ur          , Uu          , Xu          , Xu          , Uu^Vud      , Qxu^Bs\     , Qxu         , Xu          , Wo          , Xu          , Ww          , Chw         , Chw         , Chw         , Wwf         , Ww          , Ww          , Xu          , Ww          , Xu          , Xu          , Ww          , Ww          , Wo          , Ww          , Xu          , Xuc         , Uu^Vud      , Uu^Br/      , Uu^Br\      , Xuc         , Xuc         , Xuc         , Uu^Br\      , Xuc         , Ww^Br\      , Xuc         , Ww^Br/      
Hh^Ftp      , Hh^Ftp      , Hh^Ftp      , Xu          , Hh^Ft       , Hd^Es       , Hd^Es       , Xu          , Xu          , Uu^Uf       , Uue^Emf     , Xu          , Uh          , Cud         , Ur          , Xu          , Ur          , Ur          , Ur          , Uu^Vud      , Xu          , Qxu^Bs|     , Qxu         , Uu^Vud      , Cud         , Xu          , Urb         , Ww          , Wwf         , 4 Khw       , Chw         , Xu          , Xu          , Xu          , Xu          , Ww          , Xu          , Ww          , Wo          , Wo          , Wo          , Ww          , Xu          , Xuc         , Xuc         , Uue         , Uue^Br/     , Uu^Br\      , Uu^Br/      , Uu^Br/      , Xuc         , Ww^Br/      , Ww          , Ww^Br\      , Wo          
Hh^Ftp      , Hh^Ftp      , Hh^Ftp      , Hh^Ftp      , Hh^Ft       , Hh^Ft       , Hh^Ft       , Hh^Ft       , Xu          , Uue^Em      , Uue^Em      , Xu          , Uh^Emf      , Uu          , Ur          , Xu          , Ur          , Uu          , Xu          , Ur          , Ur          , Ur          , Qxu^Bs/     , Uu          , Xu          , Cud         , Urb         , Wwf         , Wwf         , Chw         , Xu          , Xu          , Xu          , Xu          , Xu          , Ww          , Ww          , Ww          , Ww          , Wo          , Ww          , Ww          , Ww          , Ww          , Xu          , Uue^Br|     , Xuce        , Xuce        , Xuce        , Uu^Br|      , Uu^Br\      , Xuc         , Xuc         , Wo          , Wo          
Hh^Ftp      , Hh^Ftp      , Hh^Ftp      , Hh^Ftp      , Xu          , Hh^Ft       , Hh^Ft       , Xu          , Xu          , Uue         , Uue         , Xu          , Uu^Uf       , Uu          , Xu          , Ur          , Uu          , Uu          , Uu          , Uu          , Ur          , Uu          , Qxu         , Qxu         , Xu          , Xu          , Xu          , Urb         , Wwf         , Xu          , Ww          , Ww          , Ww          , Xu          , Xu          , Xu          , Xuce        , Xu          , Ww          , Xu          , Ww^Ftp      , Xu          , Ww          , Xu          , Xu          , Uue^Br|     , Uue^Br\     , Uue^Vud     , Xuce        , Xuc         , Xuc         , Uu^Br|      , Uu^Br\      , Xuc         , Ww          
Mm          , Hh^Ftp      , Mm          , Xu          , Xu          , Hh^Ft       , Xu          , Xu          , Xu          , Uue         , Uue         , Xu          , Uh          , Uu          , Uu          , Uu          , Uu          , Uu^Vud      , Xu          , Ur^Vud      , Uu          , Uu          , Qxu^Bs\     , Xu          , Wo          , Wo          , Xu          , Urb^Vud     , Xu          , Xu          , Xu          , Ww          , Wo          , Ww          , Xu          , Xuce        , Cud         , Xuce        , Xuce        , Xuce        , Xuce        , Xu          , Wwf         , Ww          , Ww          , Xu          , Xu          , Uue^Br/     , Uue         , Uu          , Uu          , Xuc         , Uu^Br|      , Xuc         , Xuc         
Hh^Ft       , Mm          , Mm          , Hh^Ftr      , Hh^Ftr      , Xu          , Xu          , Xu          , Xu          , Uue^Ii      , Xu          , Xu          , Uu          , Uu          , Uu          , Uu          , Xu          , Xu          , Wo          , Xu          , Xu          , Uu          , Qxu         , Uu          , Wo          , Wo          , Xu          , Xu          , Ww          , Ww          , Ww          , Ww          , Wo          , Ww          , Xu          , Xuce        , Xuce        , Uue         , Uue         , Cud         , 8 Kud       , Xuce        , Xuce        , Wo          , Wo          , Ww          , Ww          , Xu          , Xu          , Uu          , Uh          , Xuc         , Xuc         , Cud         , Xuc         
Hh^Ft       , Hh^Ft       , Hh^Ft       , Hh^Ftr      , Hh^Ftr      , Hh^Ftr      , Hh^Ftr      , Xu          , Hh^Vo       , Uu^Ufi      , Xu          , Uu          , Uu          , Uu          , Uu          , Xu          , Wo          , Wo          , Wo          , Xu          , Xu          , Xu          , Qxu         , Qxu^Bs|     , Wo          , Wo          , Cud         , Xu          , Xu          , Ww          , Ww^Vm       , Wo          , Wo          , Ww          , Ww          , Xu          , Xu          , Xuce        , Xu          , Xuce        , Xuce        , Cud         , Ww          , Xu          , Xu          , Wo          , Ww          , Xu          , Wwf         , Xu          , Uh          , Uh          , Xuc         , Cud         , Cud         
Gs^Ft       , Gs^Ft       , Gs^Ft       , Gs^Ft       , Gs^Ft       , Gs^Ftr      , Hh^Ftr      , Hh^Ftr      , Xu          , Xu          , Ur          , Cud         , Xu          , Uu          , Uu          , Xu          , Xu          , Wo          , Wo          , Wo          , Wo          , Xu          , Xu          , Uu          , Xu          , Wo          , Xu          , 7 Kud       , Xu          , Ww          , Ww          , Wo          , Wo          , Wo          , Ww          , Xu          , Ww          , Ww          , Ww          , Xu          , Xu          , Xu          , Ww          , Ww          , Xu          , Wo          , Xu          , Ww          , Ww          , Xu          , Uh          , Uh          , Uh          , Xuc         , Cud         
Gs^Ft       , Gs^Ft       , Gs^Ft       , Gs^Ft       , Gs^Ft       , Gs^Ftr      , Hh^Ftr      , Hh^Ftr      , Xu          , Xu          , Ur          , Ur          , Ur^Vud      , Xu          , Uh^Emf      , Uh          , Uh          , Xu          , Xu          , Wo          , Wo          , Wo          , Xu          , Qxu^Bs|     , Qxu         , Wo          , Xu          , Xu          , Xu          , Xu          , Ww          , Wo          , Wo          , Wo          , Wo          , Ww          , Xu          , Mm^Vhh      , Xu          , Ww          , Ww          , Ww          , Xu          , Ww          , Xu          , Wo          , Xu          , Xu          , Ww          , Xu          , Xu          , Xu          , Xu          , Uh          , Xuc         
Gs^Ft       , Gs^Ft       , Gs^Ft       , Gs^Ft       , Gs^Ft       , Gs^Ft       , Hh^Ftr      , Hh^Ftr      , Xu          , Uu^Uf       , Uu^Emf      , Ur          , Ur          , Xu          , Xu          , Uh          , Xu          , Cud         , Uu^Ii       , Wo          , Xu          , Xu          , Uu          , Uu          , Xu          , Qxu^Bs|     , Xu          , Wo          , Wo          , Wo          , Wo          , Wo          , Wo          , Wo          , Wo          , Wo          , Wo          , Wo          , Wo          , Wwf         , Ww          , Ww          , Ww          , Wwf         , Wo          , Wo          , Wo          , Wo          , Wo          , Wo          , Wo          , Wo          , Xu          , Uh          , Uu^Uf       
Gs^Ft       , Gs^Ft       , Gs^Ft       , Gs^Ft       , Hh^Ft       , Hh^Ft       , Xu          , Xu          , Uu^Uf       , Uu^Uf       , Xu          , Xu          , Xu          , Ur          , Ur          , Xu          , Uu          , Uu          , Xu          , Uu^Ii       , Qxu         , Qxu         , Uu          , Uu          , Xu          , Uu          , Uu          , Xu          , Xu          , Wo          , Wo          , Wo          , Wo          , Wo          , Wo          , Wo          , Wo          , Wo          , Wo          , Wo          , Wo          , Ww          , Wo          , Wo          , Wo          , Wo          , Wo          , Wo          , Wo          , Wo          , Wo          , Wo          , Xu          , Uh          , Xu          
Gs^Eff      , Gs^Eff      , Dd^Vdt      , Hh^Ft       , Uu^Ufi      , Xu          , Uu^Ufi      , Xu          , Xu          , Xu          , Hh^Ft       , Hh^Ft       , Xu          , Uu^Vu       , Xu          , Ur          , Ur          , Xu          , Xu          , Xu          , Qxu^Bs\     , Xu          , Uu          , Uu          , Uu          , Uu          , Uu          , Uh          , Xu          , Xu          , Xu          , Wo          , Xu          , Wo          , Wo          , Wo          , Xu          , Wo          , Wo          , Wo          , Wo          , Wo          , Wo          , Wo          , Wo          , Wo          , Wo          , Wo          , Wo          , Wo          , Xu          , Wo          , Xu          , Uh          , Ur          
Gs          , Dd          , Hd          , Xu          , Xu          , Xu          , Ww          , Wwf         ,           Ce, 3 Ke        , Ce          , Gg^Ve       , Gs          , Xu          , Hh          , Ur^Ii       , Ur          , Ur          , Ur          , Ur          , Qxu^Bs/     , Uu          , Xu          , Xu          , Xu          , Uu          , Cud         , Xu          , Wo          , Xu          , Ur^Vu       , Xu          , Cud         , Xu          , Xu          , Wo          , Wo          , Wo          , Wo          , Wo          , Wo          , Wo          , Wo          , Wo          , Hh^Vc       , Chw         , Khr         , Wo          , Wo          , Cud         , Cud         , Xu          , Ur          , Ur          , Xu          
Wo          , Dd          , Wo          , Xu          , Wo          , Wo          , Hh          , Hh          ,           Ce,           Ce, Gs          , Hh^Ft       , Hh          , Hh          , Xu          , Xu          , Ur^Vu       , Ur          , Ur          , Ur          , Qxu         , Xu          , Xu          , Wo          , Wo          , Xu          , Ur          , Xu          , Xu          , Uu^Ii       , Ur          , Ur          , Xu          , Xu          , Wo          , Wo          , Xu          , Wo          , Xu          , Wo          , Wo          , Wo          , Xu          , Xu          , Uh^Dr       , Xu          , Cud         , Xu          , Wo          , Xu          , 9 Kud       , Ur          , Uu          , Ur          , Xu          
Gs^Ft       , Wo          , Wo          , Wo          , Hh^Ft       , Hh^Ft       , Hh          , Hh          , Hh^Ft       , Hh^Ft       , Gs          , Hh^Ft       , Hh          , Hh^Ft       , Xu          , Xu          , Xu          , Xu          , Xu          , Ur          , Ur^Vu       , Xu          , Wo          , Xu          , Wo          , Xu          , Xu          , Ur          , Ur          , Ur          , Xu          , Xu          , Wo          , Wo          , Xu          , Xu          , Urb^Vud     , Xu          , Cud         , Xu          , Xu          , Xu          , Uue^Uf      , Uue         , Uue         , Xu          , Cud         , Xu          , Wo          , Xu          , Xu          , Uu          , Uu          , Ur^Vud      , Xu          
Mm          , Dd          , Gs^Ft       , Wo          , Wo          , Hh^Ft       , Hh          , Hh          , Gs          , Gs          , Hh^Ft       , Hh^Ft       , Hh^Ft       , Ww          , Ww          , Ww          , Xu          , Wo          , Xu          , Ur          , Xu          , Xu          , Wo          , Wo          , Xu          , Wo          , Wo          , Xu          , Xu          , Ur          , Xu          , Wo          , Cud         , Cud         , Urb         , Urb         , Urb         , Urb         , Xu          , Uh          , Uu^Emf      , Uue^Uf      , Uue         , Uue         , Uue         , Xu          , Wo          , Xu          , Xu          , Wo          , Xu          , Uu          , Uu^Vud      , Uu          , Uu^Uf       
Mm          , Mm          , Mm          , Wwf         , Wo          , Wo          , Hh^Ft       , Hh          , Wo          , Wo          , Wo          , Wo          , Wwf         , Ww          , Wwf         , Xu          , Urb^Vud     , Xu          , Urb         , Cud         , Xu          , Wo          , Wo          , Xu          , Xu          , Xu          , Xu          , Wo          , Wo          , Xu          , Xu          , Wo          , Cud         , Urb         , Urb         , Urb         , Urb         , Cud         , Xu          , Xu          , Xu          , Uu          , Uu          , Xuce        , Uue         , Xu          , Xu          , Wo          , Wo          , Wo          , Wo          , Xu          , Xu          , Xu          , Xu          
Ww          , Mm          , Gs          , Xu          , Xu          , Wo          , Wo          , Wo          , Xu          , Xu          , Xu          , Xu          , Wwf         , Wwf         , Xu          , Xu          , Urb         , Urb         , Ql^Bs/      , Cud         , Cud         , Xu          , Xu          , Wo          , Wwf         , Xu          , Ql          , Xu          , Wo          , Wo          , Wo          , Wo          , Cud         , 2 Kud       , Urb         , Urb         , Cud         , Xu          , Xu          , Wo          , Wo          , Xu          , Ur^Vud      , Uu          , Uu          , Xu          , Wo          , Xu          , Xu          , Xu          , Xu          , Wo          , Wo          , Wo          , Wo          
Gs          , Ww          , Ww          , Xu          , Xu          , Xu          , Xu          , Xu          , Xu          , Xu          , Gs          , Wwf         , Gs          , Wwf         , Xu          , Urb         , Urb         , Urb         , Ql          , Ql          , Xu          , Xu          , Xu          , Xu          , Xu          , Uu^Dr       , Uh          , Xu          , Xu          , Xu          , Xu          , Wo          , Xu          , Xu          , Xu          , Xu          , Uu^Uf       , Uh          , Uu          , Xu          , Xu          , Xu          , Xu          , Ur          , Ur          , Xu          , Xu          , Wo          , Xu          , Xu          , Xu          , Wo          , Wo          , Wo          , Wo          
Xu          , Xu          , Xu          , Ww          , Xu          , Xu          , Xu          , Xu          , Xu          , Hh          , Hh          , Gs          , Hh          , Hh          , Xu          , Urb         , Urb         , Cud         , 1 Kud       , Xu          , Qlf         , Wo          , Xu          , Xu          , Uh          , Uu^Vu       , Xu          , Xu          , Wo          , Wo          , Wo          , Wo          , Wo          , Wo          , Wo          , Xu          , Xu          , Xu          , Uu^Emf      , Uu          , Uu          , Xu          , Wo          , Xu          , Xu          , Ur          , Ur          , Xu          , Xu          , Xu          , Wo          , Wo          , Wo          , Wo          , Wo          
Ur          , Ur^Ii       , Ur^Ii       , Ww          , Wwf         , Xu          , Xu          , Xu          , Uu^Ii       , Uh^Ii       , Uh^Ii       , Hh          , Xu          , Xu          , Urb         , Urb         , Cud         , Cud         , Cud         , Xu          , Qlf         , Qlf         , Xu          , Uh          , Xu          , Xu          , Wo          , Wo          , Wo          , Wo          , Co          , Ss          , Co          , Wo          , Wo          , Ss          , Ss          , Xu          , Xu          , Uu^Uf       , Uu          , Xu          , Xu          , Wo          , Wo          , Ur^Ii       , Ur^Ii       , Xu          , Wo          , Wo          , Xu          , Xu          , Xu          , Wo          , Wo          
Uu^Ufi      , Xu          , Xu          , Ur^Ii       , Xu          , Wwf         , Xue         , Uu          , Xue         , Uu^Ii       , Uu^Uf       , Xu          , Urb         , Urb         , Xu          , Xu          , Xu          , Cud         , Ql^Bs\      , Ql          , Ql          , Ql          , Xu          , Uh          , Xu          , Wo          , Wo          , Wo          , Wo          , Wo          , Ss          , Ko          , Rr^Vd       , Wo          , Wo          , Wo          , Wo          , Wwf         , Xu          , Uu^Uf       , Ur^Vud      , Uu          , Ur          , Xu          , Xu          , Wo          , Ur^Ii       , Xu          , Wo          , Xu          , Xu          , Xu          , Xu          , Xu          , Xu          
Xu          , Wo^Ii       , Xu          , Xu          , Xue         , Xue         , Uue^Emf     , Uue^Ufi     , Wwf^Ii      , Xue         , Xu          , Uu^Uf       , Xu          , Xu          , Qlf         , Qlf         , Xu          , Qlf         , Ql          , Cud         , Ql^Bs\      , Ql          , Uu^Vud      , Uu^Uf       , Xu          , Wo          , Wo          , Wo          , Wo          , Wo          , Ww          , Ww          , Ww          , Wo          , Wo          , Wo          , Wo          , Wo          , Xu          , Xu          , Xu          , Ur          , Xu          , Cud         , Cud         , Xu          , Cud         , Xu          , Xu          , Wo          , Wo          , Wo          , Wo          , Wo          , Xu          
Xu          , Wwf^Ii      , Wo^Ii       , Xue         , Xue         , Uue         , Xue         , Xue         , Wo^Ii       , Xu          , Xu          , Xu          , Qlf         , Qlf         , Xu          , Qlf         , Qlf         , Qlf         , Qlf         , Ql          , Ql          , Cud         , Xu          , Xu          , Wo          , Wo          , Wo          , Wo          , Wo          , Wo          , Ww          , Ww^Fet      , Ww          , Wo          , Wo          , Wo          , Wo          , Wo          , Wo          , Xu          , Xu          , Xu          , Xu          , Xu          , Xu          , Cud         , Cud         , Cud         , Xu          , Xu          , Wo          , Wo          , Xu          , Wo          , Wo          
Xu          , Wo^Ii       , Xue         , Xue         , Uue         , Uue         , Xue         , Xue         , Xue         , Wo^Ii       , Wo^Ii       , Xu          , Qlf         , Xu          , Qlf         , Qlf         , Qlf         , Qlf         , Ql          , Ql          , Ql          , Ur          , Xu          , Wo          , Wo          , Wo          , Wo          , Ww^Vm       , Ww          , Ww          , Ww          , Ww^Bw|r     , Ww          , Ww          , Ww          , Ww^Vm       , Wo          , Wo          , Wo          , Wo          , Xu          , Xu          , Xu          , Wo          , Wo          , Xu          , Xu          , Cud         , Cud         , Xu          , Wo          , Wo          , Wo          , Wo          , Xu          
Uu^Uf       , Xu          , Xue         , Uue         , Xue         , Xue         , Xue         , Xue         , Xue         , Wo^Ii       , Wo^Ii       , Xu          , Xu          , Xu          , Qlf         , Qlf         , Ql          , Ql          , Ql          , Ql          , Ur          , Ur          , Xu          , Wo          , Wo          , Wo          , Wo          , Wo          , Ww          , Ww          , Chw         , Chw         , Chw         , Ww          , Ww          , Wo          , Wo          , Wo          , Wo          , Wo          , Xu          , Xu          , Xu          , Wo          , Wo          , Wo          , Xu          , Xu          , Cud         , Xu          , Xu          , Wo          , Xu          , Wo          , Xu          
