border_size=1
usage=map

Wo          , Wo          , Wo          , Wo          , Wo          , Wo          , Wo          , Wo          , Wo          , Wo          , Wo          , Wo          , Wo          , Wo          , Wo          , Wo          , Wo          , Wo          , Wo          , Wo          , Wo          , Wo          , Wo          , Wo          , Wo          , Wo          , Wo          , Wo          , Wo          , Wo          , Wo          , Wo          , Wo          , Wo          , Wo          , Wo          , Wo          , Wo          , Wo          , Wo          , Wo          , Wo          , Wo          , Wo          , Wo          , Wo          , Wo          , Wo          
Wo          , Wo          , Wo          , Wo          , Wo          , Wo          , Wo          , Wo          , Wo          , Wo          , Wo          , Wo          , Wo          , Wo          , Wo          , Wo          , Wo          , Wo          , Wo          , Wo          , Wo          , Wo          , Wo          , Wo          , Wo          , Wo          , Wo          , Wo          , Wo          , Wo          , Wo          , Wo          , Wo          , Wo          , Wo          , Wo          , Wo          , Wo          , Wo          , Wo          , Wo          , Wo          , Wo          , Wo          , Wo          , Wo          , Wo          , Wo          
Wo          , Wo          , Wo          , Wo          , Wo          , Wo          , Wo          , Wo          , Wo          , Wo          , Wo          , Wo          , Wo          , Wo          , Wo          , Wo          , Wo          , Wo          , Wo          , Wo          , Wo          , Wo          , Wo          , Wo          , Wo          , Wo          , Wo          , Wo          , Wo          , Wo          , Wo          , Wo          , Wo          , Wo          , Wo          , Wo          , Wo          , Wo          , Ww          , Wo          , Ww          , Ds          , Ds          , Ww          , Wo          , Wo          , Wo          , Wo          
Wo          , Wo          , Wo          , Wo          , Wwr         , Wo          , Wwr         , Wwr         , Wo          , Wo          , Wo          , Wo          , Wo          , Wo          , Wo          , Wo          , Wo          , Wo          , Wo          , Wo          , Wo          , Wo          , Wo          , Wo          , Wo          , Wo          , Wo          , Wo          , Wo          , Wo          , Wo          , Wo          , Wo          , Wo          , Wo          , Wo          , Ds          , Ds          , Ds          , Ww          , Ds          , Ds^Vd       , Ww          , Ww          , Wo          , Wo          , Wo          , Wo          
Wo          , Wo          , Wo          , Wwr         , Wwr         , Wwr         , Wwr         , Wwr         , Wwr         , Wo          , Wo          , Wo          , Wo          , Wo          , Wo          , Wo          , Wo          , Wo          , Wo          , Wo          , Wo          , Wo          , Wo          , Wo          , Wo          , Wo          , Wo          , Wo          , Ds          , Ds          , Ds          , Ww          , Hd          , Ww          , Hd          , Ds^Es       , Dd^Vda      , Ds          , Ds^Esd      , Ds^Esd      , Ds          , Ds          , Ww          , Ww          , Ww^Ft       , Wo          , Wo^Vm       , Wo          
Wo          , Wo          , Wo          , Wwr         , Wwr         , Wwr         , Wwr         , Wwr         , Wo          , Wo          , Wo          , Wo          , Wo          , Wo          , Wo          , Wo          , Wo          , Wo          , Wo          , Wo          , Wo          , Wo          , Wo          , Wo          , Wo          , Wo          , Ds          , Ds          , Hd^Ft       , Hd^Ft       , Hd^Ft       , Hd^Ft       , Hd^Ft       , Hd          , Hd          , Dd^Do       , Ds^Gvs      , Ds          , Ds          , Ds          , Chr         , Ds          , Ds^Vd       , Wwr         , Ds^Eff      , Ww^Ft       , Ww^Ft       , Wo          
Ww          , Wo          , Wo          , Wwr         , Ww          , Ww^Vm       , Wo          , Wo          , Wo          , Wo          , Wo          , Wo          , Wo          , Wo          , Wo          , Wo          , Wo          , Wo          , Wo          , Wo          , Wo          , Wo          , Wo          , Wo          , Wo          , Ww          , Ds          , Hd^Ft       , Hd^Ft       , Hd^Ft       , Hd^Ft       , Hd^Ft       , Hd^Ft       , Hd^Ft       , Hd          , Ds^Gvs      , Ww          , Ds          , Chw         , Chw         , Chw         , Ds^Es       , Ww^Ft       , Ww^Es       , Ko^Xo       , Wo^Es       , Wo^Ft       , Wo          
Ww          , Wo          , Wo          , Wo          , Wo          , Ww          , Ww          , Wo          , Wo          , Wo          , Wo          , Wo          , Wo          , Wo          , Wo          , Wo          , Wo          , Wo          , Wo          , Wo          , Wo          , Wo          , Wo          , Wo          , Wo          , Ww          , Ds          , Hd^Ft       , Dd^Do       , Hd^Ft       , Hd^Ft       , Hd^Ft       , Hd^Ft       , Hd^Ft       , Ww^Ft       , Ww          , Wo          , 2 Khw       , Wwf         , Khw         , Chw         , Ww^Es       , Ww^Ft       , Wo^Es       , Wo^Es       , Wo^Es       , Wo          , Wo          
Ds          , Ds          , Ds          , Wo          , Wo          , Wo          , Wo          , Ww          , Wo          , Wo          , Wo          , Wo          , Wo          , Wo          , Wo          , Wo          , Wo          , Wo          , Wo          , Wo          , Wo          , Wo          , Wo          , Wo          , Wo          , Ww          , Wwr         , Ds          , Ds          , Hd^Ft       , Hd          , Hd          , Hd^Ft       , Hd^Ft       , Dd^Do       , Wo          , Wo          , Wo          , Wo          , Wwf         , Wwf         , Wo          , Wo          , Wo^Ft       , Wo          , Wo^Es       , Wo          , Wo          
Ds          , Dd^Do       , Ds          , Ww          , Wo          , Wo          , Wo          , Wo          , Wo          , Wo          , Wo          , Wo          , Wo          , Wo          , Wo          , Wo          , Wo          , Wo          , Wo          , Wo          , Wo          , Wo          , Wo          , Wo          , Wo          , Ww          , Wwr         , Wwr         , Wwr         , Ds          , Ds          , Dd^Dc       , Ds^Ft       , Ds^Ft       , Dd^Vda      , Wo          , Wo          , Wo          , Wo          , Wo          , Wo          , Wo          , Wo          , Wo          , Wo          , Wo          , Wo          , Wo          
Ww          , Ds          , Ww          , Ww          , Wo          , Wo          , Wo          , Wo          , Wo          , Wo          , Wo          , Wo          , Mm          , Wo          , Wo          , Wo          , Wo          , Wo          , Wo          , Wo          , Wo          , Wo          , Wo          , Wo          , Wo          , Wo          , Wo          , Wwr         , Wwr         , Wwr         , Wwr         , Ds          , Ds          , Dd          , Dd          , Dd          , Wo          , Wo          , Wo          , Wo          , Wo          , Wo          , Wo          , Wo          , Wo          , Wo          , Wo          , Wo          
Wo          , Ww          , Wo          , Wo          , Wo          , Wo          , Wo          , Wo          , Wo          , Wo          , Mm          , Mm          , Mm          , Mm          , Mm          , Wo          , Wo          , Wo          , Wo          , Wo          , Wo          , Wo          , Wo          , Wo          , Wo          , Wo          , Wo          , Wo          , Wwr         , Wwr         , Wwr         , Wwr         , Wwr         , Ds          , Ds          , Ds          , Ww          , Wo          , Wo          , Wo          , Ww^Ft       , Wo          , Wo          , Wo          , Wo          , Wo          , Wo          , Wo          
Wo          , Wo          , Wo          , Wo          , Wo          , Wo          , Wo          , Wo          , Wo          , Mm          , Wwg         , Wwg         , Wwg         , Mm          , Mm          , Ds          , Wo          , Wo          , Wo          , Wo          , Wo          , Wo          , Wo          , Wo          , Wo          , Wo          , Wo          , Wo          , Wo          , Wwr         , Wwr         , Wwr         , Ww          , Ww^Es       , Ww          , Ds          , Ww          , Wo          , Wwr         , Ww^Ft       , Dd^Do       , Ww^Ft       , Wo          , Wo          , Wo          , Wo          , Wo          , Wo          
Wo          , Wo          , Wo          , Wo          , Wo          , Wo          , Wo          , Wo          , Wo          , Mm          , Wwg         , Wwg         , Wwg         , Mm          , Mm          , Ds          , Ds          , Wo          , Wo          , Wo          , Wo          , Wo          , Wo          , Wo          , Wo          , Wo          , Wo          , Wo          , Wwr         , Wo          , Wo          , Ww          , Wo          , Wo          , Wo          , Ww          , Ww          , Wwr         , Wwr^Ft      , Wwr^Ft      , Ww^Vm       , Ww^Ft       , Wo          , Wo          , Wo          , Wo          , Wo          , Wo          
Wo          , Wo          , Wo          , Wo          , Wo          , Wo          , Wo          , Wo          , Wo          , Mm          , Mm          , Wwg         , Mm          , Mm          , Ds^Vct      , Ds          , Ds          , Wo          , Wo          , Wo          , Wo          , Wo          , Ds^Esd      , Ds          , Ds          , Wo          , Wwr         , Wwr         , Ww          , Wo          , Ww          , Wwr         , Wo^Ft       , Wo^Ft       , Wo^Ft       , Wwr^Ft      , Ww          , Wwr         , Wwr^Ft      , Wwr^Ft      , Wwr^Ft      , Ww^Ft       , Wo          , Wo          , Wo          , Wo          , Wo          , Wo          
Wo          , Wo          , Ds          , Ds          , Ds          , Wo          , Wo          , Wo          , Ww          , Ds          , Ds          , Mm          , Ds          , Ds          , Ds          , Ds          , Ww          , Wwr         , Wwr         , Wwr         , Ds          , Ds          , Rd          , Dd^Vdt      , Ds          , Ds          , Wwr         , Ww          , Wo          , Ww          , Ww          , Wo          , Wo          , Wo          , Ds^Ft       , Wwr^Ft      , Ww          , Ww          , Wo          , Wwr         , Wwr^Ft      , Wo          , Wo          , Wo          , Wo          , Wo          , Wo          , Wo          
Wo          , Wo          , Wo          , Ds          , Ds          , Ds          , Ds          , Wo          , Ds          , Wwr         , Wwr         , Ds          , Ww          , Ww          , Ww          , Ww          , Ww          , Wwr         , Wwr         , Wwr         , Wwr         , Ds          , Ds^Ecf      , Rd          , Ds          , Wwr         , Wwr         , Wwr         , Wo          , Wo          , Ds          , Ds          , Ds^Ft       , Ds^Ft       , Ds^Ft       , Ds^Ft       , Ww          , Wo          , Wo          , Wo          , Wo          , Wo          , Wo          , Wo          , Wo          , Wo          , Wo          , Wo          
Wo          , Wo          , Ww          , Ds          , Ds          , Ds          , Ds          , Ds          , Ds          , Ww          , Ww          , Ww          , Ww          , Ww          , Ww          , Ww          , Ww          , Ww          , Wwr         , Wwr         , Wwr         , Ds          , Ds          , Rd          , Ds          , Ww          , Wwr         , Wwr         , Wo          , Ds          , Ds          , Dd          , Dd          , Dd^Vda      , Ds          , Dd^Do       , Ds          , Wo          , Wo          , Wo          , Wo          , Wo          , Wo          , Wo          , Wo          , Wo          , Wo          , Wo          
Ww          , Ww          , Ww          , Ww          , Wwr         , Wwr         , Ww          , Ww          , Ww          , Ww          , Ww          , Ww          , Ww          , Ww          , Ww          , Ww          , Ww          , Ww          , Wwr         , Wwr         , Wwr         , Wwr         , Ww          , Ds          , Ds          , Ww          , Ww          , Wwr         , Wwr         , Wo          , Ds          , Dd          , Co          , Dd          , Co          , Ds          , Ds          , Wo          , Wo          , Wo          , Wo          , Wo          , Wo          , Wo          , Wo          , Wo          , Wo          , Wo          
Ww          , Ww          , Wwr         , Wwr         , Wwr         , Ww          , Ww          , Ww          , Ww          , Ww          , Ww          , Ww          , Ww          , Ww          , Ww          , Ww          , Ww          , Ww          , Ww          , Ww          , Ww          , Ww          , Ww          , Ww          , Ww          , Ww          , Ww          , Wwr         , Wwr         , Wwr         , Ds          , Dd          , Co          , 1 Ko        , Co          , Dd          , Ds          , Ww          , Wo          , Wo          , Wo          , Wo          , Wo          , Wo          , Wo          , Wo          , Wo          , Wo          
Wwr         , Wwr         , Wwr         , Wwr         , Ww          , Ww          , Ww          , Ww          , Ds          , Ww          , Ww          , Ww          , Ww          , Ww          , Ww          , Ww          , Ww          , Ww          , Ww          , Ww          , Ww          , Ww          , Ww          , Ww          , Ww          , Ww          , Ww          , Ww          , Wwr         , Wwr         , Wwr         , Ds          , Dd          , Co          , Dd          , Ds          , Ww          , Ww          , Wo          , Wo          , Wo          , Wo          , Wo          , Wo          , Wo          , Wo          , Wo          , Wo          
Ww          , Wwr         , Wo          , Wwr         , Ds          , Ds          , Ds          , Ds          , Ds          , Ds          , Ds          , Ds          , Ds          , Ww          , Ww          , Ww          , Ww          , Ww          , Wo          , Ww          , Wo          , Ww          , Ww          , Ww          , Ww          , Ww          , Ww          , Ww          , Ww          , Wwr         , Wwr         , Ds          , Ds          , Ds          , Ds          , Ds          , Ww          , Ww          , Wo          , Wo          , Wo          , Wo          , Wo          , Wo          , Wo          , Wo          , Wo          , Wo          
Ww          , Wo          , Wo          , Wwr         , Hd          , Hd          , Hd          , Ds          , Ds^Esd      , Ds          , Ds^Vdt      , Ds^Edpp     , Ds^Edpp     , Ds          , Ds          , Wo          , Wo          , Wo          , Wo          , Wo          , Wo          , Wo          , Wo          , Ww          , Wo          , Ww          , Wo          , Ww          , Ww          , Wwr         , Ww          , Ww          , Ww          , Ww          , Ww          , Ww          , Wo          , Wo          , Wo          , Wo          , Wo          , Wo          , Wo          , Wo          , Wo          , Wo          , Wo          , Wo          
Ww          , Wo          , Wo          , Wo          , Wo          , Hd          , Hd          , Hd          , Hd          , Hd^Vdt      , Hd^Ecf      , Dd^Vdt      , Hd^Edpp     , Hd          , Hd          , Ds          , Ds          , Ds          , Ds          , Ds          , Ds          , Wo          , Wo          , Wo          , Wo          , Wo          , Wo          , Wo          , Wo          , Ww          , Ww          , Ww          , Ww          , Ww          , Wo          , Wo          , Wo          , Wo          , Wo          , Wo          , Wo          , Wo          , Wo          , Wo          , Wo          , Wo          , Wo          , Wo          
Ww          , Wo          , Wo          , Wo          , Wo          , Ww          , Ww          , Hd          , Hd          , Hd^Vdt      , Hd^Vdt      , Hd^Vdt      , Hd^Edpp     , Hd          , Hd          , Hd          , Hd          , Ds^Esd      , Ds^Esd      , Ds          , Ds          , Wo          , Wo          , Wo          , Wo          , Wo          , Wo          , Wo          , Wo          , Wo          , Ww          , Ww          , Ww          , Wo          , Wo          , Wo          , Wo          , Wo          , Ww          , Ww          , Wo          , Wo          , Wo          , Wo          , Wo          , Wo          , Wo          , Wo          
Ww          , Ww          , Wo          , Wo          , Wo          , Wo          , Wo          , Ww          , Ww          , Ds          , Ds          , Ds          , Ds          , Ds          , Hd          , Hd          , Hd          , Hd          , Hd          , Ds^Esd      , Ds          , Ds          , Ww          , Ww          , Ww          , Wo          , Wo          , Wo          , Wo          , Wo          , Wo          , Ww          , Ww          , Wo          , Wo          , Wo          , Ww          , Ww          , Ww          , Ww          , Wo          , Wo          , Wo          , Wo          , Wo          , Wo          , Wo          , Wo          
Ww          , Ww          , Wo          , Mm          , Mm          , Wo          , Md          , Wo          , Ww          , Ww          , Ww          , Ww          , Ww          , Ds          , Ds          , Hd          , Hd          , Hd          , Hd          , Hd          , Hd          , Ds          , Hd          , Ds          , Ds          , Ww          , Ww          , Wo          , Wo          , Wo          , Wo          , Ww          , Ww          , Ww          , Ww          , Wo          , Wo          , Ww          , Ww          , Ww          , Wo          , Wo          , Wo          , Wo          , Wo          , Wo          , Wo          , Wo          
Ww          , Wo          , Wo          , Mm          , Md^Xm       , Md^Xm       , Md^Xm       , Md          , Ds^Ft       , Ww          , Ww          , Ww          , Ww          , Ds          , Ds          , Hd          , Hd          , Hd          , Hd          , Hd          , Hd          , Hd          , Hd          , Hd          , Hd          , Ds          , Ww          , Ww          , Wo          , Wo          , Wo          , Wo          , Wo          , Ww          , Ww          , Wo          , Wo          , Wo          , Wo          , Wo          , Wo          , Wo          , Wo          , Wo          , Wo          , Wo          , Wo          , Wo          
Ww          , Wo          , Wo          , Md^Xm       , Md^Xm       , Mm^Xm       , Md^Xm       , Md          , Ds^Ft       , Ds^Ft       , Dd^Do       , Ww          , Ww          , Ww          , Ww          , Hd          , Md          , Md          , Hd          , Hd          , Hd          , Hd          , Ww          , Hd          , Ww          , Ww          , Wo          , Wo          , Wo          , Wo          , Wo          , Wo          , Wo          , Ww          , Ww          , Wo          , Wo          , Wo          , Wo          , Wo          , Wo          , Wo          , Wo          , Wo          , Wo          , Wo          , Wo          , Wo          
Ww          , Wo          , Wo          , Wo          , Wo          , Md^Xm       , Md^Xm       , Ds^Ft       , Ds^Ft       , Ds^Ft       , Ww          , Ww          , Wo          , Wo          , Wo          , Wo          , Md^Xm       , Md^Xm       , Wo          , Wo          , Wo          , Wo          , Wo          , Ww          , Wo          , Wo          , Wo          , Wo          , Wo          , Wo          , Wo          , Wo          , Wo          , Wwr         , Wwr         , Ww          , Ww          , Wo          , Wo          , Wo          , Wo          , Wo          , Wo          , Wo          , Wo          , Wo          , Wo          , Wo          
