border_size=1
usage=map

Wog         , Wog         , Wog         , Wog         , Wog         , Wog         , Wog         , Wog         , Wog         , Wog         , Wog         , Wog         
Wot         , Wog         , Wog         , Wog         , Wwt         , Wog         , Wot         , Wog         , Wwt         , Wog         , Wog         , Wog         
Wot         , Wog         , Wwt         , Wwt         , Wog         , Wog         , Wot         , Wwt         , Wot         , Wog         , Wwt         , Wot         
Wot         , Wwt         , Wog         , Wog         , Wwt         , Wwt         , Wog         , Wog         , Wot         , Wwt         , Wog         , Wot         
Wot         , Wot         , Wwt         , Wwt         , Wog         , Wog         , Wwt         , Wwt         , Wog         , Wog         , Wwt         , Wot         
Wot         , Wot         , Wog         , Wog         , Wot         , Wwt         , Wot         , Wog         , Wwt         , Wwt         , Wog         , Wot         
Wot         , Wog         , Wwt         , Wwt         , Wot         , Wog         , Wog         , Wwt         , Wot         , Wog         , Wwt         , Wot         
Wot         , Wwt         , Wot         , Wog         , Wog         , Wwt         , Wot         , Wog         , Wot         , Wwt         , Wog         , Wot         
Wot         , Wog         , Wot         , Wwt         , Wot         , Wog         , Wwt         , Wot         , Wog         , Wog         , Wot         , Wot         
Wwt         , Wwt         , Wog         , Wog         , Wot         , Wwt         , Wot         , Wog         , Wot         , Wwt         , Wog         , Wot         
Wwt         , 1 Wwt       , Wwt         , Wwt         , Wwt         , Wwt         , Wwt         , Wwt         , Wwt         , Wwt         , Wwt         , Wwt         
Wwt         , Wwt         , Wwt         , Wwt         , Wwt         , Wwt         , Wwt         , Wwt         , Wwt         , Wwt         , Wwt         , Wwt         
