border_size=1
usage=map

Ww          , Mm          , Mm          , Wo          , Ww          , Mm          , Wwf         , Mm          , Mm          , Mm          , Mm          , Mm          , Mm          , Mm^Xm       , Wwf         , Mm          , Mm          , Mm          , Mm          , Mm          , Mm          , Re          , Hh          , Hh^Fds      , Gs^Fds      , Gg          , Re          , Gg          , Gg          , Gg          , Gg          , Gg          , Wo          , Wo^Ft       
Ww          , Ww          , Mm          , Wo          , Mm          , Ww          , Ww          , Mm          , Mm          , Mm          , Mm          , Mm          , Mm          , Mm          , Mm          , Wwf         , Ww          , Ww^Es       , Wwf         , Hh          , Hh          , Re          , Hh          , Gs^Fds      , Re          , Re          , Hh^Fds      , Hh          , Gg          , Gg          , Gg          , Ds          , Wo          , Wo          
Khr         , Ww          , Mm          , Wo          , Mm          , Mm          , Ww          , Mm          , Mm          , Mm          , Mm          , Mm          , Mm          , Mm          , Mm          , Mm          , Mm          , Ww          , Ww          , Wwf         , Hh          , Re          , Re          , Re          , Hh^Fds      , Hh^Fds      , Hh^Fds      , Hh          , Hh          , Hh          , Ds          , Ds          , Wwf^Bw\     , Wo          
Ww          , Wwf         , Wo          , Wo          , Wo          , Wo          , Wo          , Wo          , Wo          , Wo          , Mm          , Mm          , Mm          , Mm          , Mm          , Ww^Es       , Wo          , Wo          , Wo          , Wo          , Wo          , Ww          , Wo          , Hh^Vhh      , Mm          , Mm          , Wo          , Mm          , Wo          , Wo          , Wo          , Wo          , Wo          , Wwf^Bw|     
Wo          , Wo          , Wo          , Wo          , Wo          , Wo          , Wo          , Wo          , Wo          , Wo          , Mm          , Mm          , Mm          , Mm          , Mm          , Mm          , Ww^Ewf      , Wo          , Wo          , Wo          , Wo          , Wo          , Wo          , Wo          , Wo          , Wo          , Wo          , Wo          , Wo          , Wo          , Wo          , Wo          , Wo          , Wwf^Bw|     
Wo          , Wo          , Wo          , Wo          , Wo          , Wo          , Wo          , Wo          , Mm          , Wo          , Mm          , Mm          , Mm          , Mm          , Mm          , Mm          , Mm          , Hh^Fds      , Hh^Fds      , Wo          , Wo          , Wo          , Mm          , Wo          , Wo          , Wo          , Mm          , Wo          , Wo          , Wo          , Wo          , Wo          , Re          , Re          
Wo          , Wo          , Hh^Vc       , Chw         , 2 Khr       , Wo          , Wo          , Mm          , Mm          , Mm          , Mm          , Mm          , Mm          , Mm          , Mm          , Mm          , Mm          , Mm          , Mm          , Ww^Vhcr     , Ww^Ewl      , Wo          , Mm          , Wo          , Wo          , Mm          , Wo^Es       , Mm^Xm       , Mm^Xm       , Wo          , Wo          , Wo          , Re          , Mm          
Mm          , Mm          , Mm          , Mm          , Mm          , Mm          , Wo          , Mm          , Mm          , Mm          , Mm          , Mm          , Mm          , Wo          , Wo          , Mm          , Mm          , Mm          , Mm          , Mm^Ftp      , Ww^Ftp      , Wo          , Wo          , Mm^Xm       , Wo          , Mm^Xm       , Wo          , Mm^Xm       , Wo          , Wo          , Wo          , Wo          , Re          , Mm          
Mm          , Mm          , Mm          , Mm          , Mm          , Mm          , Wo          , Mm          , Mm          , Mm          , Mm          , Mm          , Mm          , Wo          , Wo          , Wo          , Mm          , Mm          , Mm          , Mm^Ftp      , Hh^Ftp      , Wo          , Wo          , Wo          , Wo          , Wo          , Mm^Xm       , Wo          , Wo          , Wo          , Wo          , Wo          , Wo          , Re          
Mm          , Mm          , Mm          , Mm          , Wo          , Mm          , Mm          , Wo          , Mm          , Mm          , Mm          , Mm          , Mm          , Mm          , Mm          , Mm          , Mm          , Mm          , Mm          , Mm          , Ww^Ftp      , Wo^Ftp      , Chr^Ftp     , Ww^Ftp      , Ww^Ftp      , Wo          , Wo          , Wo          , Wo          , Wo          , Mm^Xm       , Wo          , Wo          , Wo          
Mm          , Mm          , Mm          , Mm          , Mm          , Wo          , Wo          , Wo          , Wo          , Mm          , Mm          , Mm          , Mm          , Mm          , Mm          , Mm          , Mm          , Mm          , Wo          , Wo          , Chw         , Chr         , Chr         , Mm^Ftp      , Mm^Ftp      , Wo          , Wo          , Wo          , Wo          , Wo          , Wo          , Wo          , Wo          , Wo          
Mm          , Mm          , Mm          , Mm          , Wo          , Mm          , Mm          , Mm          , Mm          , Wo          , Wo          , Wo          , Wo          , Wo          , Wo          , Wo          , Wo          , Wo          , Wo          , Mm          , Mm          , 3 Kh        , Mm          , Mm          , Mm          , Wo^Es       , Mm          , Mm          , Mm          , Wo          , Wo          , Wo          , Wo          , Wwf         
Mm          , Mm          , Mm          , Mm          , Mm          , Wo          , Mm          , Mm          , Mm          , Wo          , Wo          , Wo          , Wo          , Wo          , Wo          , Mm          , Mm          , Mm          , Mm          , Wo^Es       , Mm          , Mm          , Mm          , Mm          , Mm          , Mm          , Mm          , Mm^Xm       , Mm          , Mm          , Mm          , Wo          , Wo          , Re^Bw|      
Wo          , Mm          , Mm          , Mm          , Mm          , Mm          , Mm          , Mm          , Wo          , Wo          , Wo          , Wo          , Wo          , Wo          , Mm          , Mm          , Mm          , Mm          , Mm          , Wo^Fts      , Wo^Fts      , Mm          , Mm          , Mm          , Mm          , Mm          , Mm          , Mm          , Mm          , Mm          , Mm          , Mm          , Wo^Es       , Wo^Bw|      
Mm          , Wo          , Wo          , Mm          , Mm          , Mm          , Wo          , Wo          , Mm          , Mm          , Mm          , Wo          , Wo          , Wo          , Mm          , Mm          , Mm          , Mm          , Mm          , Mm          , Wo^Es       , Wo^Ftp      , Mm          , Mm          , Mm          , Mm          , Mm          , Mm          , Wo^Ewl      , Mm          , Mm          , Mm          , Chw         , Wo^Bw|      
Mm          , Mm          , Mm          , Wo          , Mm          , Mm          , Wo          , Mm          , Mm          , Mm          , Mm          , Mm          , Mm          , Mm          , Mm          , Mm          , Mm          , Mm          , Mm          , Mm          , Mm          , Mm          , Mm          , Mm          , Mm          , Mm          , Mm          , Mm          , Mm          , Wo          , Wo^Ewl      , Mm          , Mm          , Ch          
Mm          , Mm          , Mm          , Mm          , Mm          , Mm          , Mm          , Wo          , Wo          , Wo          , Wo          , Wo          , Mm          , Mm          , Mm          , Mm          , Mm          , Mm          , Mm          , Mm          , Mm          , Mm          , Mm          , Mm          , Mm          , Mm          , Mm          , Mm          , Mm          , Mm          , Mm          , Mm          , Mm          , Kh          
Mm          , Mm          , Mm          , Mm          , Mm          , Mm          , Mm          , Mm          , Wo          , Wo          , Mm          , Wo          , Wo          , Mm          , Mm          , Mm          , Mm          , Mm          , Mm          , Mm          , Mm          , Mm          , Ww^Ftp      , Wo^Ftp      , Mm          , Mm          , Mm          , Mm          , Mm          , Mm          , Mm          , Mm          , Wo^Es       , Ch          
Mm          , Wo          , Wo          , Mm          , Mm          , Mm          , Mm          , Mm          , Wo          , Wo          , Wo          , Wo          , Mm          , Mm          , Mm          , Mm          , Mm          , Mm          , Wo^Fts      , Mm          , Mm          , Mm          , Wo^Ftp      , Mm          , Mm          , Mm          , Wo^Fms      , Wo^Fms      , Wo^Fms      , Mm          , Mm          , Mm          , Mm          , Wo          
Mm          , Wo          , Wo          , Wo          , Mm          , Mm          , Mm          , Mm          , Mm          , Wo          , Mm          , Wo          , Mm          , Mm          , Mm          , Mm          , Mm          , Wo          , Mm          , Mm          , Mm          , Mm          , Mm          , Mm          , Mm          , Ss          , Mm^Fp       , Mm^Fp       , Mm^Fp       , Wo          , Wo          , Mm          , Mm          , Mm          
Mm          , Wo          , Wo          , Mm          , Mm          , Mm          , Mm          , Mm          , Mm          , Mm          , Mm          , Wo          , Wo          , Mm          , Mm          , Mm          , Mm          , Mm          , Mm          , Mm          , Mm          , Mm          , Mm          , Mm          , Mm          , Mm^Fp       , Mm          , Mm          , Mm          , Mm^Fp       , Mm          , Mm          , Mm          , Mm          
Mm          , Mm          , Mm          , Wo          , Wo          , Mm          , Mm          , Mm          , Mm          , Mm          , Mm          , Mm          , Wo          , Mm          , Mm          , Mm          , Mm          , Mm          , Mm          , Mm          , Mm          , Mm          , Mm^Xm       , Wo^Es       , Wo          , Mm^Fp       , Wo          , Ss          , Mm          , Mm          , Wo          , Wo          , Mm          , Mm          
Mm          , Mm          , Mm          , Mm          , Mm          , Mm          , Mm          , Mm          , Wo          , Wo          , Wo          , Wo          , Wo          , Mm          , Wo          , Mm          , Mm          , Mm          , Mm          , Mm^Xm       , Mm^Xm       , Mm^Xm       , Mm          , Mm          , Wo          , Wo          , Wo          , Mm          , Mm          , Mm          , Mm          , Mm          , Mm          , Mm          
Mm          , Mm          , Mm          , Mm          , Mm          , Mm          , Mm          , Mm          , Wo          , Wo          , Mm          , Wo          , Wo          , Wo          , Wo          , Wo          , Wo          , Mm          , Mm          , Mm          , Mm          , Mm          , Mm          , Wo^Fts      , Wo          , Mm          , Wo          , Wo          , Wo          , Mm          , Mm          , Mm          , Mm          , Mm          
Mm          , Mm          , Mm          , Mm          , Mm          , Mm          , Mm          , Mm          , Wo          , Wo          , Wo          , Wo          , Wo          , Mm          , Mm          , Mm          , Mm          , Mm          , Mm^Xm       , Mm          , Mm          , Mm          , Mm          , Mm          , Mm          , Ss          , Mm          , Mm          , Wo          , Wo^Fts      , Mm          , Mm          , Mm          , Mm          
Mm          , Mm          , Mm          , Mm          , Wo          , Wo          , Wo          , Mm          , Wo          , Wo          , Wo          , Wo          , Mm          , Mm          , Mm          , Mm          , Mm          , Mm          , Mm          , Mm^Xm       , Mm^Xm       , Mm          , Mm^Xm       , Mm^Xm       , Mm^Xm       , Mm          , Mm          , Mm          , Wo^Fts      , Wo^Fts      , Mm          , Mm          , Mm          , Mm          
Mm^Xm       , Mm^Xm       , Mm^Xm       , Wo          , Mm          , Mm          , Mm          , Wo          , Mm          , Wo          , Wo          , Mm          , Mm          , Mm          , Mm          , Mm          , Mm          , Mm          , Mm          , Mm          , Mm          , Mm^Xm       , Mm^Xm       , Mm^Xm       , Mm          , Mm          , Mm          , Mm          , Mm          , Wo^Fts      , Mm          , Mm          , Mm          , Mm          
Mm^Xm       , Mm          , Mm          , Mm^Xm       , Mm^Xm       , Mm          , Mm          , Mm          , Mm          , Mm          , Mm          , Wo          , Ww          , Mm          , Mm          , Mm          , Mm          , Mm          , Mm          , Mm          , Mm          , Mm          , Mm          , Mm          , Mm          , Mm          , Mm          , Mm          , Mm          , Mm          , Mm          , Mm          , Mm          , Mm          
Mm^Xm       , Mm          , Mm          , Mm          , Mm          , Mm          , Mm          , Mm          , Mm          , Mm          , Mm          , Mm          , Ww          , Mm          , Mm          , Mm          , Mm          , Mm          , Mm^Xm       , Mm          , Mm          , Mm          , Mm          , Mm          , Mm          , Mm          , Ww          , Ww          , Ss          , Mm          , Mm          , Mm          , Mm          , Mm          
Mm^Xm       , Mm          , Mm          , Mm          , Mm          , Mm          , Mm          , Mm          , Mm          , Mm          , Mm          , Mm          , Wo          , Mm          , Mm          , Mm          , Mm          , Mm          , Mm          , Mm          , Mm          , Mm          , Mm          , Mm          , Mm          , Mm          , Wo          , Ww          , Ss          , Ss          , Ss          , Mm          , Mm          , Mm          
Mm^Xm       , Mm          , Wo          , Mm          , Mm          , Mm          , Mm          , Mm          , Mm          , Mm          , Mm          , Wo          , Mm          , Mm          , Mm          , Mm          , Mm^Xm       , Mm          , Mm          , Mm          , Mm          , Mm          , Wo          , Mm          , Mm          , Wo          , Wo          , Mm^Xm       , Wo          , Wo          , Ss          , Xu          , Xu          , Xu          
Mm          , Wo^Es       , Mm          , Wo          , Mm          , Mm          , Mm          , Mm          , Mm          , Mm          , Wo          , Wo          , Wo          , Mm          , Wo          , Mm          , Mm          , Mm          , Mm          , Mm          , Wo          , Wo          , Wo          , Wo          , Wo          , Wo          , Wo          , Wo          , Wo          , Wo          , Cud         , Xu          , Cud         , Uu          
Mm          , Mm          , Wo          , Wo          , Mm          , Mm          , Mm          , Mm          , Wo          , Wo          , Mm          , Mm          , Mm          , Wo          , Mm          , Wo          , Wo          , Mm          , Wo          , Wo          , Wo          , Wo          , Wo          , Wo          , Wo          , Wo          , Wo          , Wo          , Wo          , Xu          , Xu          , 1 Kud       , Xu          , Ur          
Mm          , Mm          , Mm          , Wo          , Wo          , Mm          , Wo          , Wo          , Mm          , Mm          , Mm          , Mm          , Mm          , Ww^Es       , Mm          , Wo          , Wo          , Wo          , Wo          , Wo          , Wo          , Wo          , Wo^Ftp      , Wo          , Wo          , Wo          , Wo          , Wo          , Wo          , Wo          , Xu          , Cud         , Ur          , Ur          
Ww          , Mm          , Wo          , Wo          , Wo          , Wo          , Mm          , Mm          , Mm          , Mm          , Ww          , Ww^Vm       , Wo          , Mm          , Wo          , Ww          , Mm          , Mm          , Mm          , Wo          , Mm          , Mm^Ft       , Hh^Ftp      , Ww^Ftp      , Ww^Ftp      , Wwr         , Wwr         , Wo          , Wo          , Wo          , Xu          , Cud         , Ur          , Ur          
Wo          , Wo          , Wo          , Wo          , Mm          , Mm          , Mm          , Wwf^Es      , Wo          , Mm          , Wo          , Wo          , Wo          , Wo          , Wo          , Wo          , Mm          , Mm          , Wo          , Wo          , Mm          , Mm          , Hh^Ft       , Ww^Es       , Ww          , Wwr         , Ww          , Wwr         , Chw         , Chw         , Xu          , Xu          , Xu          , Xu          
Wo          , Wo          , Wo          , Wo          , Mm          , Mm          , Mm          , Wo          , Wo          , Wo          , Wo          , Wo          , Wo          , Wo          , Ww^Vm       , Wo          , Wo          , Wo          , Wo          , Wo          , Mm          , Mm          , Mm          , Ww^Ewf      , Ww^Es       , Ww          , Ww          , Ww          , Chw         , Khw         , Chr         , Mm^Xm       , Mm^Xm       , Mm          
Mm          , Wo          , Wo          , Wo          , Mm          , Mm          , Mm          , Wo          , Mm          , Wo          , Wo          , Wo          , Mm          , Mm          , Mm          , Mm          , Mm          , Wo          , Wo          , Wo          , Wo          , Mm          , Mm          , Mm          , Mm          , Ww^Es       , Wwr^Es      , Wwr^Es      , Wwr^Es      , Wwf         , Hhd^Es      , Mm^Xm       , Mm          , Mm          
