border_size=1
usage=map

Ur          , Ur          , Xu          , Xu          , Xu          , Uu          , Uu          , Uu^Vud      , Uu          , Xu          , Ww^Ewl      , Wo          , Mm          , Wo          , Wo          , Mm          , Wo^Es       , Mm^Xm       , Mm^Xm       , Wo          , Wo          , Wo          , Re          , Mm          , Mm          , Mm          , Mm          , Mm          , Wo^Es       , Wo^Es       , Wo^Fts      , Wwf         , Mm          , Mm          , Mm          , Mm          , Mm          , Mm          , Mm          , Mm          
Uu          , Ur          , Xu          , Wo          , Wo          , Xu          , Xu          , Uu          , Uu          , Xu          , Ww^Ftp      , Wo          , Wo          , Mm^Xm       , Wo          , Mm^Xm       , Wo          , Mm^Xm       , Wo          , Wo          , Wo          , Wo          , Re          , Mm          , Mm          , Mm          , Mm          , Wo^Es       , Wo          , Wo^Fts      , Mm^Ftr      , Mm          , Mm          , Mm          , Mm          , Mm          , Mm          , Mm          , Mm          , Mm          
Uu          , Ur^Vud      , Xu          , Wo          , Wo          , Wo          , Xu          , Uu          , Xu          , Xu          , Hh^Ftp      , Wo          , Wo          , Wo          , Wo          , Wo          , Mm^Xm       , Wo          , Wo          , Wo          , Wo          , Wo          , Wo          , Re          , Re          , Mm          , Wo          , Wo          , Wo          , Wo^Fts      , Mm^Ftr      , Mm          , Mm          , Mm          , Ww          , Mm          , Mm          , Mm          , Mm          , Mm          
Uu^Vud      , Uu          , Uu^Uf       , Xu          , Xu          , Xu          , Cud         , Cud         , Xu          , Mm          , Ww^Ftp      , Wo^Ftp      , Chr^Ftp     , Ww^Ftp      , Ww^Ftp      , Wo          , Wo          , Wo          , Wo          , Wo          , Mm^Xm       , Wo          , Wo          , Wo          , Wo^Bh|      , Wo^Es       , Wo          , Mm^Xm       , Wo          , Wo          , Mm          , Mm          , Mm          , Mm          , Wo          , Wo          , Wo          , Mm          , Mm          , Mm          
Xu          , Xu          , Xu          , Xu          , Xu          , Xu          , Xu          , Xu          , Wo          , Wo          , Chw         , Chr         , Chr         , Xu          , Xu          , Wo          , Wo          , Wo          , Wo          , Wo          , Wo          , Wo          , Wo          , Wo          , Wwf^Bw|     , Wo          , Wo          , Wo          , Mm          , Wo          , Wwf         , Wo          , Wo          , Wo          , Wo          , Mm          , Mm          , Wo          , Mm          , Mm          
Wo          , Wo          , Wo          , Wo          , Wo          , Wo          , Wo          , Wo          , Wo          , Xu          , Xuc         , 2 Khw       , Xuc         , Uh^Dr       , Xu          , Wo^Es       , Xuc         , Xuc         , Xuc         , Wo          , Wo          , Wo          , Wo          , Wwf         , Mm^Bw/      , Wo^Es       , Mm          , Mm          , Mm          , Mm          , Mm          , Wo          , Wo          , Wo          , Mm          , Mm          , Mm          , Wo          , Mm          , Mm          
Wo          , Wo          , Wo          , Wo          , Wo          , Xu          , Xu          , Xu          , Xu          , Wo^Es       , Xuc         , Cud         , Xuc         , Uu^Br|      , Uu^Br\      , Xuc         , Ur          , Ur          , Ur^Vud      , Xuc         , Xu          , Wo          , Wo          , Re^Bw|      , Mm          , Mm          , Mm          , Mm          , Mm          , Mm          , Mm          , Mm          , Mm          , Mm          , Mm          , Mm          , Mm          , Wo          , Mm^Xm       , Ww          
Wo          , Wo          , Wo          , Wo          , Xu          , Xu          , Ur^Vud      , Xu          , Xu          , Wo^Fts      , Wo^Fts      , Xuc         , Xu          , Xu          , Uu^Br|      , Ur          , Xuc         , Xuc         , Xu          , Xuc         , Xu          , Xu          , Wo^Es       , Wo^Bw|      , Wo          , Mm          , Mm          , Mm^Xm       , Mm^Xm       , Mm          , Mm          , Mm          , Mm          , Mm          , Mm          , Mm          , Mm          , Wo          , Wo          , Wo          
Xu          , Wo          , Wo          , Wo          , Xu          , Xu          , Ur          , Ur          , Uue         , Xu          , Wo^Es       , Wo^Ftp      , Xuc         , Xuc         , Uu^Br/      , Ur          , Ur^Vud      , Xu          , Wo^Ewl      , Xu          , Xu          , Xu          , Chw         , Wo^Bw|      , Wo          , Wo          , Wo          , Mm          , Mm          , Mm          , Mm^Xm       , Mm^Xm       , Mm^Xm       , Mm          , Mm          , Mm          , Mm          , Mm          , Mm          , Mm          
Xu          , Xu          , Xu          , Xu          , Ur          , Ur          , Xuce        , Uue         , Xuce        , Uue         , Ur^Ii       , Xuc         , Uu^Br/      , Uu^Br/      , Uu          , Ur          , Ur          , Xuc         , Uu          , Wo          , Wo^Ewl      , Xu          , Xu          , Ch          , Ch          , Wo          , Wo          , Wo          , Wo^Fts      , Wwf         , Wwf^Es      , Mm          , Mm          , Mm          , Mm          , Mm          , Mm          , Mm          , Mm          , Mm          
Wo          , Wo          , Xu          , Xu          , Ur          , Xuce        , Uue         , Uue         , Uue         , Uue         , Ur          , Wo^Bs/      , Uu^Vu       , Uu          , Xu          , Ur          , Ur          , Ur          , Ur          , Uu          , Ur^Vud      , Xu          , Xu          , 1 Kh        , Chw         , Wo^Bh\      , Wo^Bh\      , Wo          , Re          , Wo^Fts      , Mm          , Wwf^Es      , Mm^Vhh      , Mm          , Ww          , Mm          , Mm          , Mm          , Mm          , Mm          
Xu          , Wo          , Wo          , Xu          , Ur          , Xuce        , Uue         , Uue         , Xu          , Uue^Vu      , Ur          , Xu          , Ww^Ftp      , Wo^Ftp      , Xu          , Ur^Vud      , Xu          , Xuc         , Xuc         , Ur          , Ur          , Xuc         , Wo^Es       , Ch          , Wo          , Wo          , Wo          , Re          , Xu          , Re          , Re          , Wwf^Bh/     , Ww          , Ww          , Ww          , Ww          , Ww          , Mm          , Mm          , Hh          
Wo          , Wo          , Xu          , Xu          , Ur          , Ur          , Xu          , Xu          , Wo^Fts      , Xu          , Ur          , Xu          , Wo^Ftp      , Xu          , Xu          , Xu          , Wo^Fms      , Wo^Fms      , Wo^Fms      , Uu^Ii       , Uu^Ii       , Xuc         , Xuc         , Wo          , Wo          , Wo          , Wo          , Wo^Ftr      , Xu          , Xu          , Re          , Mm          , Mm          , Ww          , Ww          , Mm          , Ww          , Mm          , Mm          , Hh          
Xu          , Wo          , Xu          , Xu          , Ur          , Ur          , Xu          , Wo          , Xu          , Xu          , Ur          , Xu          , Xu          , Xu          , Xu          , Ss          , Xu          , Xu          , Xu          , Wo          , Wo          , Uu^Ii       , Ur          , Xuc         , Wo          , Wo          , Wo          , Wo^Ftr      , Xu          , Re          , Mm          , Mm          , Mm          , Ww          , Mm          , Mm          , Ww          , Mm          , Mm          , Hh          
Xu          , Wo          , Wo          , Xu          , Xu          , Ur          , Uu          , Xu          , Ur^Vud      , Xu          , Ur          , Ur^Vud      , Xu          , Xu          , Xu          , Xu          , Xu          , Xu          , Xu          , Xu          , Xu          , Xu          , Uu          , Xuc         , Xuc         , Wo          , Wo^Ewl      , Wo^Ftr      , Xu          , Re          , Re          , Mm          , Mm          , Mm          , Mm          , Mm          , Ww          , Mm          , Mm          , Hh          
Xu          , Xu          , Wo          , Xu          , Xu          , Uu^Uf       , Uu^Uf       , Uu          , Ur          , Ur          , Uu^Emf      , Xu          , Xu          , Wo^Es       , Wo          , Xu          , Wo          , Ss          , Xu          , Xu          , Wo          , Wo          , Xuc         , Ur          , Ur          , Xuc         , Xuc         , Xuc         , Xuc         , Xu          , Xu          , Re          , Mm          , Mm          , Mm          , Mm          , Mm          , Ww          , Ww          , Ww          
Wo          , Wo          , Wo          , Xu          , Wo          , Xu          , Xu          , Xu          , Xu          , Ur          , Uu          , Xu          , Xu          , Xu          , Wo          , Wo          , Wo          , Xu          , Xu          , Xu          , Xu          , Xuc         , Ur^Vu       , Ur          , Xuc         , Ur          , Ur          , Ur          , Ur          , Xuc         , Xuc         , Re          , Mm          , Mm          , Mm          , Mm          , Mm          , Mm          , Hh          , Ww          
Xu          , Wo          , Wo          , Wo          , Wo          , Wo          , Wo          , Xu          , Xu          , Ur          , Ur          , Uu          , Uu^Ii       , Wo^Fts      , Wo          , Xu          , Wo          , Wo          , Wo          , Xu          , Xu          , Xu          , Xu          , Xuc         , Xue         , Xuc         , Xuc         , Ur          , Ur          , Ur^Ii       , Uu^Ufi      , Re          , Re          , Mm          , Mm          , Mm          , Mm          , Mm          , Hh          , Hh          
Wo          , Wo          , Wo          , Xu          , Xu          , Xu          , Xu          , Xu          , Xu          , Ur          , Ur          , Xu          , Xu          , Uu^Ii       , Uu          , Ss          , Xu          , Xu          , Wo          , Wo^Fts      , Xu          , Xu          , Xu          , Xuc         , Xuc         , Uu          , Uu          , Uu          , Uu          , Xuc         , Xu          , Xu          , Re          , Mm          , Mm          , Mm          , Mm          , Wwf         , Hh          , Hh          
Wo          , Wo          , Xu          , Xu          , Xu          , Xu          , Xu          , Xu          , Ur          , Ur          , Ur          , Xu          , Xu          , Uu^Vud      , Xu          , Uu          , Uu          , Uu^Ii       , Wo^Fts      , Wo^Fts      , Xu          , Xu          , Uu^Emf      , Uu^Uf       , Uu^Emf      , Xuc         , Uu          , Uu          , Xuc         , Wo          , Xu          , Xu          , Xu          , Re          , Re          , Mm          , Mm          , Ww^Ewl      , Ww          , Gg          
Wo          , Xu          , Xu          , Xu          , Xu          , Xu          , Xu          , Xu          , Ur          , Ur          , Xu          , Xu          , Ur          , Xu          , Xu          , Uu          , Uu          , Uu          , Uu          , Wo^Fts      , Xu          , Xu          , Uu          , Uu^Vu       , Xuc         , Xuc         , Uu          , Uu          , Uh          , Xu          , Xu          , Xu          , Xu          , Xu          , Re          , Mm^Vhh      , Hh          , Hh^Fp       , Hh^Fp       , Ww          
Xu          , Wo          , Ww^Xo       , Ur^Vud      , Xu          , Xu          , Ur          , Ur          , Ur          , Ur          , Ur          , Ur          , Ur          , Ur          , Ur          , Uu          , Xu          , Xu          , Xu          , Uu          , Uu          , Uu          , Xu          , Uu          , Xuc         , Uu^Vu       , Uu          , Uu          , Xuc         , Xu          , Xu          , Xu          , Xu          , Xu          , Mm          , Re          , Hh          , Hh^Fp       , Gg          , Hh^Fp       
Cud         , Ur          , Xu          , Ur          , Cud         , Ur          , Ur          , Ur          , Ur^Vud      , Ur          , Ur          , Ur          , Ur          , Ur          , Xu          , Xu          , Ww          , Ww          , Ss          , Xu          , Xu          , Uu          , Uu          , Uu          , Xuc         , Uu          , Uu          , Xuc         , Wo          , Wo^Ewf      , Xu          , Xu          , Xu          , Xu          , Re          , Re          , Re          , Gg          , Gg          , Gg^Efm      
Xu          , Xu          , Wo          , Xu          , Xu          , Xu          , Cud         , Cud         , Cud         , Ur          , Xu          , Xu          , Xu          , Ur^Vud      , Xu          , Xu          , Wo          , Ww          , Ss          , Ss          , Ss          , Xu          , Uu          , Uu          , Uu          , Xuc         , Uu          , Xuc         , Xuc         , Wo          , Wo          , Xu          , Xu          , Xu          , Re          , Hh          , Hh          , Re          , Re          , Gg          
Xu          , Wo          , Xu          , Xu          , Xu          , Xu          , Xu          , 4 Kud       , Xu          , Xu          , Xu          , Xu          , Wo          , Xu          , Xu          , Wo          , Wo          , Xu          , Wo          , Wo          , Wo^Xo       , Xu          , Xu          , Uu          , Uu          , Xuc         , Uu^Uf       , Uu          , Uu          , Xuc         , Xuc         , Wo          , Re          , Re          , Wwf         , Wwf         , Wo          , Wwf         , Ss          , Re          
Wo          , Wo          , Wo          , Xu          , Wo          , Xu          , Xu          , Xu          , Xu          , Xu          , Wo          , Wo          , Wo          , Wo          , Wo          , Wo          , Wo          , Wo          , Wo          , Wo^Xo       , Cud         , Xu          , Cud         , Uu          , Uu^Emf      , Xu          , Uu^Emf      , Xuc         , Uu          , Uu          , Xuc         , Wo          , Wo^Bp|      , Wo          , Wo          , Wo          , Wo          , Wo          , Wo          , Ss          
Xu          , Xu          , Xu          , Wo          , Xu          , Wo          , Wo          , Xu          , Wo          , Wo          , Wo          , Wo          , Wo          , Wo          , Wo          , Wo          , Wo          , Wo          , Wo          , Xu          , Xu          , 3 Kud       , Xu          , Ur          , Xu          , Xu          , Cud         , Uu^Uf       , Uu^Vu       , Uu^Emf      , Xuc         , Wo          , Wo^Bp|      , Wo          , Wo          , Wo          , Wo          , Wo          , Ss          , Ss          
Uue^Ii      , Uue^Ii      , Xu          , Ww^Es       , Xu          , Wo          , Wo          , Wo          , Wo          , Wo          , Wo          , Wo          , Wo^Ftp      , Wo          , Wo          , Wo          , Wo          , Wo          , Wo          , Wo          , Xu          , Cud         , Ur          , Ur          , Ur^Vud      , Xu          , 5 Kud       , Xu          , Xuc         , Xuc         , Wo^Bw/      , Wo^Bp/      , Wo          , Wo          , Wo          , Wo          , Wo          , Ss          , Ss          , Ss          
Ww          , Ww^Vm       , Wo          , Xu          , Wo          , Ww          , Xu          , Xu          , Xu          , Wo          , Xu          , Xu          , Xu          , Ww^Ftp      , Ww^Ftp      , Wwr         , Wwr         , Wo          , Wo          , Wo          , Xu          , Cud         , Ur          , Ur          , Xu          , Xu          , Xu          , Xu          , Re          , Wo^Bw/      , Wwf         , Wo          , Wo          , Wo          , Wo          , Wo          , Ss          , Ss          , Ds          , Ss          
Wo          , Wo          , Wo          , Wo          , Wo          , Wo          , Xu          , Xu          , Wo          , Wo          , Xu          , Xu          , Xu          , Ww^Es       , Ww          , Wwr         , Ww          , Wwr         , Chw         , Chw         , Xu          , Xu          , Xu          , Xu          , Xu          , Xu          , Xu          , Xu          , Re          , Wwf         , Wo          , Wo          , Wo          , Wo          , Ww          , Ss          , Wwf         , Ds          , Ds          , Ss          
Wo          , Wo          , Wo          , Wo          , Ww^Vm       , Wo          , Wo          , Wo          , Wo          , Wo          , Mm          , Mm          , Mm          , Ww^Ewf      , Ww^Es       , Ww          , Ww          , Ww          , Chw         , Khw         , Chr         , Mm^Xm       , Mm^Xm       , Mm          , Mm          , Mm          , Mm          , Mm^Ve       , Re          , Wo^Es       , Wo          , Wo          , Ss          , Wo          , Ss          , Ww          , Ww          , Ss          , Ss          , Ss          
