border_size=1
usage=map

Wo          , Wo          , Mm^Xm       , Mm          , Mm          , Mm          , Mm^Xm       , Mm^Xm       , Mm^Xm       , Mm          , Mm^Xm       , Mm          , Mm^Xm       , Mm          , Mm          ,           _s,           _s,           _s,           _s,           _s,           _s,           _s,           _s,           _s,           _s,           _s,           _s,           _s,           _s,           _s,           _s,           _s,           _s,           _s,           _s,           _s,           _s,           _s,           _s,        Mm^Xm, Mm          , Wo          , Mm          , Wo          , Wo          , Mm          , Mm          , Mm          , Mm          , Mm          , Mm          , Mm          , Mm          , Mm          , Mm          , Mm^Xm       , Mm^Xm       , Mm^Xm       , Mm          , Mm          , Mm          , Mm          , Mm          , Wo^Fts      , Mm          , Mm          , Mm          , Mm          , Mm          , Mm          
Mm          , Mm          , Mm^Xm       , Mm          , Mm          , Mm^Xm       , Mm          , Mm          , Mm          , Mm^Xm       , Mm          , Mm^Xm       , Mm          , Mm^Xm       , Mm^Xm       ,           _s,           _s,           _s,           _s,           _s,           _s,           _s,           _s,           _s,           _s,           _s,           _s,           _s,           _s,           _s,           _s,           _s,           _s,           _s,           _s,           _s,           _s,           _s,           _s,        Mm^Xm, Mm          , Mm          , Mm          , Mm          , Mm          , Wo          , Ww          , Mm          , Mm          , Mm          , Mm          , Mm          , Mm          , Mm          , Mm          , Mm          , Mm          , Mm          , Mm          , Mm          , Mm          , Mm          , Mm          , Mm          , Mm          , Mm          , Mm          , Mm          , Mm          , Mm          
Wo          , Mm          , Mm          , Mm^Xm       , Mm^Xm       , Mm^Xm       , Mm^Xm       , Mm          , Mm          , Mm          , Mm          , Mm^Xm       , Mm^Xm       , Mm          , Mm          , Mm          ,           _s,           _s,           _s,           _s,           _s,           _s,           _s,           _s,           _s,           _s,           _s,           _s,           _s,           _s,           _s,           _s,           _s,           _s,           _s,           _s,           _s,           _s,        Mm^Xm,        Mm^Xm, Mm          , Mm          , Mm          , Mm          , Mm          , Mm          , Mm^Xm       , Mm          , Mm          , Mm          , Mm          , Mm          , Mm^Xm       , Mm          , Mm          , Mm          , Mm          , Mm          , Mm          , Mm          , Ww          , Ww          , Ss          , Mm          , Mm          , Mm          , Mm          , Mm          , Mm          , Mm          
Mm          , Mm          , Mm          , Mm          , Mm          , Mm          , Mm^Xm       , Ww          , Ww          , Mm          , Mm          , Mm          , Mm          , Mm^Xm       , Mm^Xm       , Mm          ,           _s,           _s,           _s,           _s,           _s,           _s,           _s,           _s,           _s,           _s,           _s,           _s,           _s,           _s,           _s,           _s,           _s,           _s,           _s,           _s,           _s,           _s,        Mm^Xm,        Mm^Xm, Mm          , Mm          , Mm          , Mm          , Mm          , Mm          , Wo          , Mm          , Mm          , Mm          , Mm          , Mm          , Mm          , Mm          , Mm          , Mm          , Mm          , Mm          , Mm          , Mm          , Wo          , Ww          , Ss          , Ss          , Ss          , Mm          , Mm          , Mm          , Mm          , Mm          
Mm^Xm       , Mm          , Mm          , Mm          , Mm          , Mm          , Mm^Xm       , Mm          , Mm          , Ww          , Ww          , Ww          , Mm^Xm       , Mm^Xm       , Mm^Xm       , Mm          ,        Mm^Xm,           _s,           _s,           _s,           _s,           _s,           _s,           _s,           _s,           _s,           _s,           _s,           _s,           _s,           _s,           _s,           _s,           _s,           _s,           _s,        Mm^Xm,        Mm^Xm,        Mm^Xm,        Mm^Xm, Mm          , Mm          , Mm          , Mm          , Mm          , Wo          , Mm          , Mm          , Mm          , Mm          , Mm^Xm       , Mm          , Mm          , Mm          , Mm          , Mm          , Wo          , Mm          , Mm          , Wo          , Wo          , Mm^Xm       , Wo          , Wo          , Wo          , Mm          , Mm          , Mm          , Mm          , Mm^Xm       
Mm          , Mm^Xm       , Mm^Xm       , Mm          , Mm          , Mm          , Wo          , Mm^Xm       , Mm          , Mm          , Mm^Xm       , Wwf         , Mm          , Mm^Xm       , Mm^Xm       , Mm^Xm       ,        Mm^Xm,        Mm^Xm,           _s,           _s,           _s,           _s,           _s,           _s,           _s,           _s,           _s,           _s,           _s,           _s,           _s,           _s,           _s,           _s,        Mm^Xm,        Mm^Xm,        Mm^Xm,        Mm^Xm,        Mm^Xm,        Mm^Xm, Mm          , Mm          , Mm          , Mm          , Wo          , Wo          , Wo          , Mm          , Wo          , Mm          , Mm          , Mm          , Mm          , Mm          , Wo          , Wo          , Wo          , Wo          , Wo          , Wo          , Wo          , Wo          , Wo          , Wo          , Mm          , Mm          , Mm          , Mm          , Mm^Xm       , Mm^Xm       
Md          , Mm          , Mm          , Mm^Xm       , Mm          , Wo          , Mm          , Mm^Xm       , Mm^Xm       , Mm          , Ww          , Wwf         , Mm^Xm       , Mm^Xm       , Mm          , Mm^Xm       ,        Mm^Xm,        Mm^Xm,        Mm^Xm,        Mm^Xm,        Mm^Xm,        Mm^Xm,        Mm^Xm,        Mm^Xm,        Mm^Xm,        Mm^Xm,        Mm^Xm, _s          ,        Mm^Xm,        Mm^Xm,        Mm^Xm,        Mm^Xm,        Mm^Xm,        Mm^Xm,        Mm^Xm,        Mm^Xm,        Mm^Xm,        Mm^Xm,        Mm^Xm,        Mm^Xm, Mm          , Mm          , Wo          , Wo          , Mm          , Mm          , Mm          , Wo          , Mm          , Wo          , Wo          , Mm          , Wo          , Wo          , Wo          , Wo          , Wo          , Wo          , Wo          , Wo          , Wo          , Wo          , Wo          , Mm          , Mm          , Mm          , Mm          , Mm^Xm       , Mm^Xm       , Mm^Xm       
Md          , Md          , Md          , Mm          , Wo          , Mm          , Mm          , Mm^Xm       , Mm          , Ww          , Mm          , Mm^Xm       , Mm          , Hh          , Mm          , Mm          , Mm          , Mm^Xm       , Mm^Xm       , Mm^Xm       , Mm^Xm       , Mm^Xm       , Mm^Xm       , Mm^Xm       , Mm^Xm       , Mm^Xm       , Mm^Xm       , Mm^Xm       , Mm          , Mm          , Mm          , Mm          , Mm          , Mm          , Mm          , Mm          , Mm          , Wo          , Wo          , Mm          , Wo          , Wo          , Mm          , Mm          , Mm          , Mm          , Mm          , Ww^Es       , Mm          , Wo          , Wo          , Wo          , Wo          , Wo          , Wo          , Wo          , Wo^Ftp      , Wo          , Wo          , Wo          , Wo          , Wo          , Wo          , Wo          , Mm^Xm       , Mm          , Mm^Xm       , Mm^Xm       , Mm          , Mm^Xm       
Md          , Md          , Md          , Mm          , Mm          , Wo          , Mm          , Mm^Xm       , Mm^Xm       , Mm          , Mm^Xm       , Mm^Xm       , Mm          , Mm          , Wo          , Mm          , Mm          , Mm          , Mm          , Mm          , Mm          , Mm^Xm       , Mm          , Mm^Xm       , Mm          , Mm          , Mm          , Mm          , Mm          , Mm          , Mm          , Mm          , Mm          , Mm          , Ww          , Mm          , Wo          , Wo          , Wo          , Wo          , Mm          , Mm          , Mm          , Mm          , Ww          , Ww^Vm       , Wo          , Mm          , Wo          , Ww          , Mm          , Mm          , Mm          , Wo          , Mm          , Mm^Ft       , Hh^Ftp      , Ww^Ftp      , Ww^Ftp      , Wwr         , Wwr         , Wo          , Wo          , Wo          , Mm^Xm       , Mm^Xm       , Mm          , Mm          , Mm          , Mm          
Md          , Md          , Wo          , Wo          , Wo          , Mm          , Wo          , Mm          , Mm          , Mm^Xm       , Mm^Xm       , Mm          , Wo          , Wo          , Wo          , Md          , Md          , Mm          , Mm          , Mm          , Mm          , Mm          , Mm          , Mm          , Mm          , Mm          , Mm          , Mm          , Wo          , Wo^Es       , Wo          , Mm          , Mm          , Ww^Vm       , Wo          , Wo          , Wo          , Wo          , Mm          , Mm          , Mm          , 3 Ww^Kov    , Wo^Cov      , Mm          , Wo          , Wo          , Wo          , Wo          , Wo          , Wo          , Mm          , Mm          , Wo          , Wo          , Mm          , Mm          , Hh^Ft       , Ww^Es       , Ww          , Wwr         , Ww          , Wwr         , Chw         , Chw         , Mm^Xm       , Mm          , Mm          , Mm          , Mm          , Mm          
Md          , Md          , Md          , Wo          , Wo          , Wo          , Wo          , Wo          , Wo          , Wo          , Wo          , Wo          , Wo          , Wo          , Wo          , Hhd^Vhcr    , Md          , Md          , Wo          , Wo          , Wo          , Wo          , Wo          , Wo          , Wo          , Wo          , Wo          , Wo          , Wo          , Wo          , Wo          , Wo          , Wo          , Wo          , Wo          , Wo          , Wo          , Wo          , Mm          , Mm          , Mm          , Wo^Cov      , Wo          , Wo          , Wo          , Wo          , Wo          , Wo          , Ww^Vm       , Wo          , Wo          , Wo          , Wo          , Wo          , Mm          , Mm          , Mm          , Ww^Ewf      , Ww^Es       , Ww          , Ww          , Ww          , Chw         , 1 Khw       , Chr         , Mm^Xm       , Mm^Xm       , Mm          , Mm          , Mm          
Md          , Md          , Md          , Md          , Md          , Md          , Md          , Md          , Md          , Wo          , Wo          , Wo          , Md          , Wo          , Md          , Md          , Md          , Md          , Wo          , Wo          , Wo          , Wo          , Wo          , Wo          , Wo          , Wo          , Mm          , Wo          , Wo          , Wo          , Wo          , Wo          , Wo          , Wo          , Mm          , Wo          , Wo          , Wo          , Mm          , Mm          , Mm          , Wo          , Mm          , Wo          , Wo          , Wo          , Mm          , Mm          , Mm          , Mm          , Mm          , Wo          , Wo          , Wo          , Wo          , Mm          , Mm          , Mm          , Mm          , Ww^Es       , Wwr^Es      , Wwr^Es      , Wwr^Es      , Wwf         , Hhd^Es      , Mm^Xm       , Mm          , Mm          , Mm          , Mm          
Wo          , Md          , Md          , Md          , Md          , Md          , Md          , Hhd^Vd      , Md          , Wo          , Wo          , Md          , Hhd^Vd      , Md          , Md          , Md          , Md          , Md          , Wo          , Wo          , Mm          , Mm          , Mm          , Wo          , Wo          , Ww^Vm       , Mm          , Mm          , Wo          , Wo          , Wo          , Wo          , Mm          , Mm          , Mm          , Mm          , Wo          , Wo          , Wo          , Mm          , Wo          , Wo          , Ww^Vm       , Mm          , Wo          , Wo          , Mm          , Mm          , Mm          , Mm          , Mm          , Mm          , Wo          , Wo          , Wo          , Wo          , Mm          , Mm          , Mm          , Ww^Es       , Ww^Es       , Wwr^Es      , Ww^Vm       , Wwf         , Mm          , Mm^Xm       , Mm^Xm       , Mm          , Mm          , Mm          
Wo          , Wo          , Wo          , Md          , Md          , Md          , Md          , Md          , Wo          , Wo          , Wo          , Md          , Md          , Md          , Md          , Md          , Wo          , Wo          , Wo          , Wo^Es       , Mm          , Mm          , Mm          , Mm          , Wo          , Mm          , Mm          , Mm          , Wo          , Wo          , Wo          , Mm          , Mm          , Mm          , Mm          , Mm          , Wo          , Wo          , Mm          , Wo          , Wo          , Wo          , Mm          , Mm          , Wo          , Wo          , Wo          , Mm          , Mm          , Mm          , Hh          , Hh          , Wo          , Wo          , Wo          , Wo          , Wo          , Mm          , Mm          , Mm          , Mm          , Ww^Ewf      , Wwf         , Wwf         , Mm          , Mm          , Mm          , Mm^Xm       , Mm          , Mm          
Wo          , Wo          , Wo          , Wo          , Wo          , Md          , Wo          , Wo          , Wo          , Wo          , Wo          , Wo          , Wo          , Md          , Wo          , Wo          , Mm          , Wo^Es       , Mm          , Mm          , Mm          , Mm^Xm       , Mm          , Mm          , Wo          , Mm          , Wo          , Mm          , Wo          , Wo          , Wo          , Mm          , Mm          , Mm          , Mm          , Wo          , Wo          , Mm          , Wo          , Wo          , Wo          , Wo          , Wo          , Mm          , Mm          , Wo          , Wo          , Wo          , Wo          , Ww^Es       , Wo          , Wo          , Wo          , Wo          , Mm          , Wo          , Wo          , Mm          , Mm          , Mm          , Mm          , Mm          , Mm          , Hhd         , Mm          , Mm          , Mm          , Mm^Xm       , Mm^Xm       , Mm          
Wo          , Wo          , Wo          , Wo          , Wo          , Wo          , Wo          , Wo          , Wo          , Wo          , Wo          , Wo          , Wo          , Wo          , Md          , Md          , Md          , Md          , Md          , Mm          , Mm          , Mm          , Mm          , Mm          , Wo          , Wo          , Wo          , Wo          , Wo          , Wo          , Mm          , Hh          , Hh          , Mm          , Hh          , Wo          , Wo          , Mm          , Wo          , Wo          , Wo          , Wo          , Wo          , Wo          , Wo          , Wo          , Mm          , Wo          , Wo          , Wo          , Wo          , Wo          , Wo          , Wo          , Hh^Efm      , Ww^Vhhr     , Wo          , Wo          , Wo          , Mm          , Mm          , Mm^Xm       , Mm          , Ms^Vhha     , Mm          , Mm          , Mm          , Mm          , Wo^Dr       , Wwf^Bw/r    
Wo          , Wo          , Wo          , Wo          , Wo          , Wo          , Wo          , Wo          , Wo          , Wo          , Wo          , Wo          , Wo          , Wo          , Md          , Md          , Md          , Md          , Md          , Mm          , Mm          , Mm          , Mm          , Wo          , Mm          , Wo          , Mm          , Wo          , Wo          , Wo          , Mm          , Mm          , Hh          , Hh          , Wo          , Wo          , Wo          , Wo          , Mm          , Mm          , Mm          , Wo          , Wo          , Wo          , Wo          , Mm          , Mm          , Mm          , Mm          , Wo          , Wo          , Wo          , Hh          , Ww          , Ww          , Wo          , Wo          , Wo          , Wo          , Wo          , Mm          , Mm          , Mm          , Mm          , Hhd^Es      , Wwf^Bw\r    , Wwf^Bw\r    , Wo^Bw/r     , Wo          , Wo          
Mm          , Mm          , Mm          , Wo          , Ww^Vm       , Mm          , Mm          , Mm          , Mm          , Wo          , Wo          , Wo          , Wo          , Wo          , Wo          , Md          , Wo          , Md          , Wo          , Wwf^Es      , Mm          , Mm          , Ww          , Ww          , Mm          , Mm          , Mm          , Mm          , Ww          , Ww          , Ww          , Hh^Vd       , Ww          , Wo          , Wo          , Wo          , Wo          , Hh          , Mm          , Mm          , Mm          , Mm          , Mm          , Wo          , Ww^Es       , Mm          , Mm          , Mm          , Mm          , Mm          , Mm          , Mm          , Mm          , Hh          , Wo          , Wo          , Wo          , Wo          , Wo          , Wo          , Mm          , Mm          , Mm          , Mm^Xm       , Wo^Es       , Wwf^Es      , Wo          , Wo          , Wo          , Wo          
Hd^Ft       , Mm          , Mm          , Mm          , Mm          , Mm          , Mm          , Mm          , Rr^Vd       , Mm          , Mm          , Wo          , Wo          , Wo          , Wo          , Wo          , Md          , Wo          , Md          , Md          , Md          , Mm          , Ww^Vhhr     , Ww          , Ww          , Mm          , Mm          , Mm          , Ww          , Ww          , Ww          , Ww          , Ww          , Wo          , Wo          , Wo          , Hh          , Mm          , Mm          , Mm          , Mm          , Mm          , Ww^Vm       , Mm          , Wo          , Wo          , Ww^Es       , Mm          , Mm^Xm       , Mm^Xm       , Mm          , Mm          , Mm          , Hh          , Wo          , Wo          , Mm          , Mm          , Wo          , Wo          , Mm          , Mm          , Mm          , Wo^Es       , Wo          , Wo          , Wo          , Wo          , Wo          , Wo          
Hd^Ft       , Hd^Ft       , Mm          , Mm          , Ds^Ft       , Dd^Es       , Mm          , Mm          , Mm          , Mm          , Mm          , Wo          , Wo          , Wo          , Md          , Md          , Wo          , Wo          , Md          , Md          , Md          , Hd          , Hhd         , Ww^Es       , Md          , Ww          , Ww          , Ww          , Ww^Es       , Mm          , Mm          , Ww          , Mm          , Ww          , Ww          , Hh^Vd       , Mm          , Mm          , Mm          , Mm          , Mm          , Mm          , Wo          , Wo          , Mm^Cov      , Wo          , Mm          , Mm          , Mm^Vhhr     , Mm          , Mm          , Mm          , Mm          , Wo          , Wo          , Wo          , Mm          , Ww^Vm       , Wo          , Wo          , Wo          , Mm          , Mm          , Wo          , Wo          , Wo          , Wo          , Wo          , Wo          , Wo          
Hd^Ft       , Hd^Ft       , Hd^Ftp      , Hd^Ftp      , Ds^Ftd      , Mm          , Dd^Do       , Mm          , Mm          , Mm          , Mm          , Wo          , Wo          , Md          , Mm          , Mm          , Wo          , Wo          , Wo          , Md          , Md          , Md          , Md          , Md          , Md          , Md          , Mm          , Ww^Es       , Mm          , Mm          , Hh^Efm      , Hh^Efm      , Wo          , Mm          , Ww          , Mm          , Mm          , Mm          , Mm          , Mm          , Mm          , Mm          , Wo          , Hh          , 2 Mm^Kov    , Ww          , Mm          , Mm          , Mm          , Mm          , Mm          , Mm          , Wo          , Wo          , Wo          , Mm          , Wo          , Wo          , Wo          , Wo          , Wo          , Wo          , Wo          , Wo          , Wo          , Mm          , Wo          , Wo          , Mm          , Mm          
Dd^Vdt      , Mm          , Mm          , Mm          , Wot^Ewf     , Hd^Ftd      , Ds          , Ds          , Ds          , Mm          , Mm          , Wo          , Wo          , Wo          , Wo          , Wo          , Wo          , Wo          , Wo          , Wo          , Wo          , Md          , Md          , Md          , Md          , Md          , Wo          , Mm          , Wo          , Ww^Vm       , Wo          , Wo          , Wo          , Wo          , Wo          , Wo          , Wo          , Wo          , Wo          , Mm          , Wo          , Wo          , Wo          , Mm^Cov      , Wo          , Wo          , Wo          , Mm          , Wo          , Mm          , Wo          , Wo          , Wo          , Wo          , Wo          , Wo          , Wo          , Wo          , Wo          , Wo          , Wo          , Wo          , Wo          , Wo          , Wo          , Wo          , Wo          , Wo          , Wo          , Wwf         
Ds          , Hd^Ftd      , Mm          , Wot         , Wot         , Wwt         , Wwt         , Wwt         , Ds^Ecf      , Dd^Vdt      , Mm          , Mm          , Wo          , Wo          , Wo          , Wo          , Wo          , Wo          , Wo          , Wo          , Wo          , Wo          , Wo          , Wo          , Wo          , Wo          , Wo          , Wo          , Wo          , Wo          , Wo          , Wo          , Mm          , Mm          , Mm          , Wo          , Wo          , Wo          , Wo          , Wo          , Wo          , Wo          , Mm          , Wo          , Wo          , Wo          , Wo          , Wo          , Wo          , Wo          , Wo          , Wo          , Ww          , Ww          , Ww          , Wo          , Wo          , Wo          , Wo          , Mm          , Wo          , Wo          , Wo          , Wo          , Wo          , Wo          , Wo          , Wo          , Wo          , Wo          
Wwt         , Wwt         , Wot         , Wot         , Wot         , Wot         , Wot         , Wwt         , Mm          , Ds          , Mm          , Mm          , Wo          , Wo          , Wo          , Wo          , Md          , Wo          , Wo          , Wo          , Wo          , Wo          , Wo          , Wo          , Wo          , Wo          , Wo          , Md          , Md          , Wo          , Wo          , Mm          , Mm          , Mm          , Mm          , Mm          , Wo          , Wo          , Wo          , Wo          , Mm          , Mm          , Mm          , Wo          , Wo          , Ww^Vd       , Wo          , Wo          , Wo          , Wo          , Mm          , Ww          , Hh          , Ww^Vm       , Mm          , Mm          , Wo          , Wo          , Wo          , Wo          , Wo          , Wo          , Mm          , Mm          , Mm          , Wo          , Wo          , Wo          , Wo          , Wo          
Wot         , Wot         , Wo          , Wo          , Mm          , Wo          , Wo          , Wot         , Wot         , Mm          , Mm          , Wo          , Wo          , Wo          , Wo          , Hhd^Vhcr    , Dd^Es       , Md          , Md          , Mm          , Wo          , Wo          , Wo          , Wo          , Wo          , Wo          , Wo          , Md          , Md          , Mm          , Wot         , Mm          , Mm          , Mm^Xm       , Mm          , Mm          , Wo          , Wo          , Wo          , Wo          , Wo          , Wo          , Wo          , Wo          , Wo          , Wo          , Wo          , Wo          , Mm          , Mm          , Mm          , Mm          , Mm          , Mm          , Mm          , Mm          , Wo          , Wo          , Wo          , Wo          , Wo          , Mm          , Mm^Xm       , Mm^Xm       , Mm          , Wo          , Wo          , Wo          , Wo          , Wo          
Wo          , Wo          , Mm          , Mm          , Wwg         , Mm          , Wo          , Wo          , Mm          , Mm          , Wo          , Wo          , Wo          , Wo          , Wo          , Ww^Es       , Wwr         , Ww^Es       , Md          , Mm          , Mm          , Wo          , Wwf^Es      , Ww^Vm       , Mm          , Wo          , Wot         , Wot         , Wot         , Wot         , Wot         , Wot         , Mm          , Mm          , Mm          , Wo          , Wo          , Wo          , Wo          , Wo          , Wo          , Wo          , Wo          , Wo          , Wo          , Wo          , Mm          , Mm          , Mm          , Mm          , Wwr         , Wwr         , Wo          , Wwr         , Wo          , Wo          , Wo          , Wo          , Wo          , Wo          , Wo          , Mm          , Mm          , Mm          , Wo          , Wo          , Wo          , Wo          , Wo          , Wo          
Wo          , Wo          , Mm          , Wwg         , Wwg         , Mm          , Wo          , Wo          , Wo          , Wo          , Wo          , Wo          , Wo          , Wo          , Wo          , Wo          , Wo          , Wwr         , Wo          , Md          , Wwr         , Mm          , Mm          , Mm          , Mm          , Mm          , Wot         , Wot         , Wot         , Wot         , Wot         , Wot         , Wot         , Mm          , Wo          , Wo          , Wo          , Wo          , Mm          , Mm          , Mm          , Wo          , Wo          , Wo          , Wo          , Wo          , Wo          , Mm          , Wwr         , Wwr         , Wo          , Wo          , Wo          , Wo          , Wo          , Wo          , Wo          , Wo          , Wo          , Wo          , Wo          , Wo          , Wo          , Wo          , Wo          , Wo          , Wo          , Wo          , Wo          , Wo          
Wo          , Mm          , Mm          , Wwg         , Mm          , Mm          , Wo          , Wo          , Wo          , Wo          , Wo          , Wo          , Wo          , Wo          , Wo          , Wo          , Wo          , Wo          , Wo          , Wo          , Wo          , Wwr         , Wo          , Wwr         , Wo          , Wo          , Wo          , Wot         , Wot         , Wot         , Wot         , Wot         , Wot         , Wot         , Wot         , Md          , Md          , Wwrt        , Wo          , Ww^Es       , Wot         , Wo          , Wot         , Wot         , Wot         , Wo          , Wot         , Wo          , Wo          , Wo          , Wo          , Wo          , Wo          , Wo          , Wo          , Wo          , Wo          , Wo          , Wo          , Wo          , Wo          , Wo          , Wo          , Wo          , Wo          , Wo          , Wo          , Wo          , Wo          , Wo          
