border_size=1
usage=map

Re          , Gs          , Wwf         , Wo          , Gs^Ft       , Wo          , Wo          , Wo          , Hh^Ft       , Hh^Ft       , Hh          , Hh          , Hh^Ft       , Hh^Ft       , Gs          , Hh^Ft       , Hh          , Hh^Ft       , Xu          , Xu          , Xu          , Xu          , Xu          , Ur          , Ur^Vu       , Xu          , Wo          , Xu          , Wo          , Xu          , Xu          , Ur          , Ur          , Ur          , Xu          , Xu          , Wo          , Wo          , Xu          , Xu          , Urb^Vud     , Xu          , Cud         , Xu          , Xu          , Xu          
Gs^Ft       , Re          , Ww          , Mm          , Mm          , Dd          , Gs^Ft       , Wo          , Wo          , Hh^Ft       , Hh          , Hh          , Gs          , Gs          , Hh^Ft       , Hh^Ft       , Hh^Ft       , Ww          , Ww          , Ww          , Xu          , Wo          , Xu          , Ur          , Xu          , Xu          , Wo          , Wo          , Xu          , Wo          , Wo          , Xu          , Xu          , Ur          , Xu          , Wo          , Cud         , Cud         , Urb         , Urb         , Urb         , Urb         , Xu          , Uh          , Uu^Emf      , Uue^Uf      
Ww          , Ww          , Ww          , Gs^Vct      , Mm          , Mm          , Mm          , Wwf         , Wo          , Wo          , Hh^Ft       , Hh          , Wo          , Wo          , Wo          , Wo          , Wwf         , Ww          , Wwf         , Xu          , Urb^Vud     , Xu          , Urb         , Cud         , Xu          , Wo          , Wo          , Xu          , Xu          , Xu          , Ql          , Wo          , Wo          , Xu          , Xu          , Wo          , Cud         , Urb         , Urb         , Urb         , Urb         , Cud         , Xu          , Xu          , Xu          , Uu          
Gs^Ft       , Ww          , Ww^Ft       , Wwf         , Ww          , Mm          , Gs          , Xu          , Xu          , Wo          , Wo          , Wo          , Xu          , Xu          , Xu          , Xu          , Wwf         , Wwf         , Xu          , Xu          , Urb         , Urb         , Ql^Bs/      , Cud         , Cud         , Xu          , Xu          , Wo          , Wwf         , Xu          , Ql          , Xu          , Wo          , Wo          , Wo          , Wo          , Cud         , 5 Kud       , Urb         , Urb         , Cud         , Xu          , Xu          , Wo          , Wo          , Xu          
Dd^Ft       , Gs^Ft       , Gs          , Gs^Ft       , Gs          , Ww          , Ww          , Xu          , Xu          , Xu          , Xu          , Xu          , Xu          , Xu          , Gs          , Wwf         , Gs          , Wwf         , Xu          , Urb         , Urb         , Urb         , Ql          , Ql          , Xu          , Xu          , Xu          , Xu          , Xu          , Xu          , Uh          , Xu          , Xu          , Xu          , Xu          , Wo          , Xu          , Xu          , Xu          , Xu          , Uu^Uf       , Uh          , Uu          , Xu          , Xu          , Xu          
Dd          , Dd^Ft       , Dd          , Gs^Ft       , Xu          , Xu          , Xu          , Ww          , Xu          , Xu          , Xu          , Xu          , Xu          , Hh          , Hh          , Gs          , Hh          , Hh          , Xu          , Urb         , Urb         , Cud         , 3 Kud       , Xu          , Qlf         , Wo          , Xu          , Xu          , Uh          , Uu^Vu       , Xu          , Xu          , Wo          , Wo          , Wo          , Wo^Xo       , Wo          , Wo          , Wo          , Xu          , Xu          , Xu          , Uu^Emf      , Uu          , Uu          , Xu          
Dd          , Dd          , Xu          , Xu          , Ur          , Ur^Ii       , Ur^Ii       , Ww          , Wwf         , Xu          , Xu          , Xu          , Uu^Ii       , Uh^Ii       , Uh^Ii       , Hh          , Xu          , Xu          , Urb         , Urb         , Cud         , Cud         , Cud         , Xu          , Qlf         , Qlf         , Xu          , Uh          , Xu          , Xu          , Wo          , Wo          , Wo          , Wo          , Co          , Ss          , Co          , Wo          , Wo          , Ss          , Ss          , Xu          , Xu          , Uu^Uf       , Uu          , Xu          
Dd^Esd      , Xu          , Ur^Vud      , Ur          , Uu^Ufi      , Xu          , Xu          , Ur^Ii       , Xu          , Wwf         , Xue         , Uu          , Xue         , Uu^Ii       , Uu^Uf       , Xu          , Urb         , Urb         , Xu          , Xu          , Xu          , Cud         , Ql^Bs\      , Ql          , Ql          , Ql          , Xu          , Uh          , Xu          , Wo          , Wo          , Wo          , Wo          , Wo          , Ss          , 6 Ko        , Rr^Vd       , Wo          , Wo          , Wo          , Wo          , Wwf         , Xu          , Uu^Uf       , Ur^Vud      , Uu          
Xu          , Xu          , Ur          , Ur          , Xu          , Wo^Ii       , Xu          , Xu          , Xue         , Xue         , Uue^Emf     , Uue^Ufi     , Wwf^Ii      , Xue         , Xu          , Uu^Uf       , Xu          , Xu          , Qlf         , Qlf         , Xu          , Qlf         , Ql          , Cud         , Ql^Bs\      , Ql          , Uu^Vud      , Uu^Uf       , Xu          , Wo          , Wo          , Wo          , Wo          , Wo          , Ww          , Ww          , Ww          , Wo          , Wo          , Wo          , Wo          , Wo          , Xu          , Xu          , Xu          , Ur          
Xu          , Xu          , Ur          , Ur          , Xu          , Wwf^Ii      , Wo^Ii       , Xue         , Xue         , Uue         , Xue         , Xue         , Wo^Ii       , Xu          , Xu          , Xu          , Qlf         , Qlf         , Xu          , Qlf         , Qlf         , Qlf         , Qlf         , Ql          , Ql          , Cud         , Xu          , Xu          , Wo          , Wo          , Wo          , Wo          , Wo          , Wo          , Ww          , Ww^Fet      , Ww          , Wo          , Wo          , Wo          , Wo          , Wo          , Wo          , Xu          , Xu          , Xu          
Xu          , Xu          , Ur          , Ur          , Xu          , Wo^Ii       , Xue         , Xue         , Uue         , Uue         , Xue         , Xue         , Xue         , Wo^Ii       , Wo^Ii       , Xu          , Qlf         , Xu          , Qlf         , Qlf         , Qlf         , Qlf         , Ql          , Ql          , Ql          , Ur          , Xu          , Wo          , Wo          , Wo          , Wo          , Ww^Vm       , Ww          , Ww          , Ww          , Ww^Bw|r     , Ww          , Ww          , Ww          , Ww^Vm       , Wo          , Wo          , Wo          , Wo          , Xu          , Xu          
Xuce        , Xue         , Ur          , Ur          , Uu^Uf       , Xu          , Xue         , Uue         , Xue         , Xue         , Xue         , Xue         , Xue         , Wo^Ii       , Wo^Ii       , Xu          , Xu          , Xu          , Qlf         , Qlf         , Ql          , Ql          , Ql          , Ql          , Ur          , Ur          , Xu          , Wo          , Wo          , Wo          , Wo          , Wo          , Ww          , Ww          , Chw         , Chw         , Chw         , Ww          , Ww          , Wo          , Wo          , Wo          , Wo          , Wo          , Xu          , Xu          
Xuce        , Ur^Vud      , Ur          , Ur          , Cud         , Xu          , Xue         , Uue         , Xue         , Wo^Ii       , Wo^Ii       , Xue         , Xu          , Xue         , Xu          , Wo^Ii       , Xu          , Xu          , Qlf         , Ql          , Qlf         , Ql          , Xu          , Ql          , Ur          , Xu          , Wo          , Wo          , Wo          , Wo          , Wo          , Ww          , Chw         , Chw         , Khw         , Khw         , Khw         , Chw         , Chw         , Ww          , Wo          , Wo          , Wo          , Wo          , Wo          , Xu          
Xuce        , Ur          , Ur          , Cud         , 2 Kud       , Cud         , Xue         , Uue         , Xue         , Wo^Ii       , Xue         , Xu          , Xu          , Xu          , Ur^Vud      , Xu          , Xu          , Xu          , Xu          , Qlf         , Xu          , Xu          , Ur          , Ql^Bs/      , Ur          , Xu          , Wo          , Chr         , Wo^Bw\      , Wo          , Wo^Bw/      , Ww^Bw/      , Chw         , Khw         , Khw         , Khw         , Khw         , Khw         , Chw         , Ww^Bw\      , Wo^Bw\      , Wo          , Wo^Bw/      , Ch          , Wo          , Xu          
Xuce        , Ur          , Ur          , Cud         , Xue         , Xue         , Uue         , Uue         , Xue         , Xue         , Uu          , Ql^Bs/      , Ur          , Ur          , Xu          , Xu          , Wwf         , Ur^Vud      , Ur          , Xu          , Xu          , Ur          , Ql          , Ql^Bs\      , Cud         , Xu          , Wo          , Wo          , Wo          , Ww^Vm       , Wo          , Ww          , Chw         , Khw         , Khw         , Ql          , Khw         , Khw         , Chw         , Ww          , Wo          , Ww^Vm       , Wo          , Wo          , Wo          , Xu          
Xue         , Ur^Vud      , Ur          , Xuce        , Xuce        , Uue^Uf      , Xue         , Xue         , Uu          , Uu          , Xu          , Ql^Bs\      , Ur          , Ur          , Xu          , Xu          , Xu          , Ww          , Ur          , Ur          , Uu          , Uu          , Uu          , Ql^Bs/      , Ur          , Xu          , Wo          , Wo          , Wo          , Wo^Bh|      , Wo          , Ww          , Chw         , Khw         , Khw         , Khw         , Khw         , Khw         , Chw         , Ww          , Wo          , Wo^Bh|      , Wo          , Wo          , Wo          , Xu          
Xu          , Xue         , Xuc         , Ur          , Ur          , Ur          , Xue         , Uu          , Xu          , Xu          , Wo^Ii       , Xu          , Xu          , Ur          , Ur          , Ur          , Ur          , Ur          , Uu          , Xu          , Uu          , Uu          , Uu          , Ql^Bs\      , Ur          , Xu          , Xu          , Wo          , Wo          , Wo^Bh|      , Wo^Bw/      , Ww^Bw/      , Ww          , Chw         , Chw         , Khw         , Chw         , Chw         , Ww          , Ww^Bw\      , Wo^Bw\      , Wo^Bh|      , Wo          , Wo          , Xu          , Xu          
Xu          , Xuc         , Xuc         , Ur          , Xuce        , Xue         , Ur          , Ur          , Xu          , Hh^Ii       , Wo^Ii       , Wo^Ii       , Wo^Ii       , Xu          , Xu          , Ur          , Xu          , Uu          , Uu          , Uu          , Xu          , Xu          , Xu          , Ql          , Ql          , Ur          , Xu          , Wo          , Wo          , Ww^Vm       , Ww^Bw\      , Wo          , Wo          , Ww          , Ww          , Chw         , Ww          , Ww          , Wo          , Wo          , Wo^Bw/      , Ww^Vm       , Wo          , Wo          , Xu          , Xu          
Xuc         , Ur^Vud      , Ur          , Ur          , Xuc         , Ur          , Ur          , Ur          , Xu          , Uu^Vud      , Wwf^Ii      , Wo^Ii       , Wo^Ii       , Wo^Ii       , Xu          , Cud         , Cud         , Uu          , Uu          , Uu          , Xu          , Xu          , Qlf         , Ql          , Ql^Bs/      , Ur          , Xu          , Wo          , Wo          , Wo          , Ww          , Wo^Bw\      , Wo^Bw\      , Wo          , Wo          , Ww^Bw|      , Wo          , Wo          , Wo^Bw/      , Ww^Vm       , Ss          , Ss          , Ss          , Wwf         , Xu          , Xu          
Xu          , Ur          , Ur          , Xuc         , Ur^Vud      , Ur          , Xu          , Xu          , Wwf^Ii      , Wwf^Ii      , Wo^Ii       , Wwf^Ii      , Xuc         , Xuc         , Xu          , 4 Kud       , Cud         , Xu          , Ur^Vud      , Uu^Uf       , Xu          , Qlf         , Ql          , Qlf         , Ql          , Ur          , Ur          , Xu          , Wo          , Wo          , Wo          , Ww          , Ww          , Wo^Bw\      , Ww^Bw\      , Wo^Bw|      , Wo^Bw/      , Wo^Bw/      , Ss          , Ss          , Ss          , Ss          , Ss          , Xu          , Xu          , Xu          
Xu          , Xuc         , Ur          , Xuc         , Ur          , Ur          , Xu          , Hh^Ii       , Xu          , Uu^Ii       , Xuc         , Wo^Ii       , Wo^Ii       , Xuc         , Xu          , Cud         , Xu          , Xu          , Xu          , Xu          , Ql^Bs\      , Ql^Xo       , Cud         , Ql          , Uu          , Ql^Bs/      , Ur          , Xu          , Xu          , Wo          , Wo          , Ww          , Ww          , Ww          , Ww          , Ww^Vm       , Wo          , Wo          , Wo          , Ss          , Ss          , Ss          , Xu          , Xu          , Xu          , Uh          
Hd^Edpp     , Xuc         , Ur          , Xuc         , Xuc         , Ur          , Ur          , Xu          , Xu          , Uu^Ii       , Ur          , Xuc         , Xu          , Xuc         , Xu          , Ur          , Xu          , Uu^Vud      , Xu          , Ww          , Ww          , Xu          , Xu          , Ql^Xo       , Ql^Xo       , Ql          , Ur          , Xu          , Xu          , Wo          , Wo          , Wo          , Wo          , Ww          , Wo          , Ww^Bw|      , Wwf         , Wo          , Ss          , Ss          , Ss          , Ss          , Xu          , Xu          , Ur          , Ur          
Dd^Edpp     , Xu          , Xuc         , Ur          , Xuc         , Ur          , Xu          , Xu          , Ur          , Ur          , Xu          , Xu          , Xue         , Xue         , Qxu^Xo      , Uu          , Ur          , Ur          , Xu          , Xu          , Xu          , Ww^Ii       , Ww^Ii       , Ww^Ii       , Xu          , Ur^Vud      , Xu          , Ur          , Ur          , Xu          , Xu          , Wo          , Xu          , Wo          , Xu          , Ww^Bw|      , Xu          , Wwf         , Mm^Vc       , Ss          , Xu          , Xu          , Xu          , Ur          , Ur          , Ur          
Wwf^Es      , Xu          , Xu          , Ur          , Ur          , Ur          , Xu          , Ur          , Ur          , Xu          , Wwf^Es      , Xuc         , Uue^Ii      , Uue         , Uue^Vud     , Xu          , Xu          , Xu          , Wo          , Xu          , Xu          , Xu          , Xu          , Wwf^Ii      , Xuc         , Xu          , Xu          , Xu          , Ur          , Ur          , Xu          , Xu          , Xu          , Xos         , Cud         , Cud         , Cud         , Xos         , Xu          , Xu          , Uu^Uf       , Uu^Emf      , Uu          , Cud         , Cud         , Xu          
Wwf^Es      , Xu          , Wwf^Es      , Xu          , Xu          , Ur          , Ur          , Ur          , Xu          , Xu          , Ww          , Ww          , Xue         , Uue         , Xue         , Xue         , Xu          , Wo          , Xu          , Xu          , Xu          , Xu          , Ww          , Wwf^Ii      , Cud         , Xuc         , Xuc         , Xu          , Xu          , Cud         , Ur          , Ur          , Ur          , Cud         , Cud         , 1 Kud       , Cud         , Cud         , Ur          , Ur          , Ur          , Uu          , Uu          , Uu^Emf      , Uu^Uf       , Xu          
Xu          , Xu          , Ww          , Ww          , Ww          , Xu          , Xu          , Ur^Vud      , Xu          , Ww          , Xu          , Xu          , Xue         , Uue         , Xue         , Xue         , Wo          , Xu          , Xu          , Xu          , Wwf         , Ww          , Cud         , Cud         , Xuc         , Hh^Ii       , Xu          , Xu          , Xu          , Ur^Vud      , Xu          , Ur          , Ur          , Ur          , Ur          , Cud         , Ur          , Ur          , Ur          , Ur          , Xu          , Xu          , Xu          , Uu^Vud      , Xu          , Xu          
Ww          , Ww          , Wo          , Ww          , Wo          , Ww          , Ww          , Xu          , Wwf         , Ww          , Wwf^Es      , Xu          , Xue         , Uue         , Uue^Vu      , Uue^Ufi     , Xu          , Wo          , Xu          , Xu          , Xu          , Xuc         , Xuc         , Xuc         , Xu          , Xu          , Wo          , Xu          , Uue         , Xu          , Uue^Vud     , Xu          , Xu          , Ur          , Ur          , Ur          , Ur          , Ur          , Xu          , Xu          , Xu          , Xu          , Xu          , Xu          , Uue^Emf     , Uue         
Wo          , Wo          , Wo          , Wo          , Wo          , Wo          , Wo          , Ww          , Wo          , Wwf         , Xu          , Xu          , Xu          , Xu          , Wo          , Wo          , Wo          , Xu          , Wo          , Xu          , Xu          , Xu          , Xu          , Xu          , Wo          , Wo          , Wo          , Xu          , Xu          , Uue^Ufi     , Xu          , Xu          , Xu          , Xu          , Xu          , Xu          , Xu          , Xu          , Xu          , Xu          , Wo          , Wo^Es       , Wo          , Uue^Ii      , Xu          , Ww^Vm       
