border_size=1
usage=map

Wo^Ii       , Wo^Ii       ,           Xu,           Xu,           Xu,           Xu,           Xu,           Xu, Xu          , Xu          , Qlf         , Ql          , Ql^Bs/      , Ur          , Xu          ,           Xu,           Xu,           Xu,           Xu,           Xu,           Xu,           Xu,           Xu,           Xu,           Xu,           Xu,           Xu,           Xu,           Xu,           Xu,           Xu,           Xu,           Xu,           Xu,           Xu,           Xu,           Xu,           Xu,           Xu,           Xu,           Xu,           Xu,           Xu, Wo          , Wo          , Xu          , Xu          , Xu          , Xu          ,           Xu,           Xu,           Xu,           Xu,           Xu,           Xu,           Xu,           Xu,           Xu,           Xu,           Xu,           Xu, Uu          , Uu          , Wo^Fts      , Xu          , Xu          , Uu          , Uu^Vu       , Xuc         , Xuc         
Xuc         , Xuc         ,           Xu,           Xu,           Xu,           Xu,           Xu,           Xu, Xu          , Qlf         , Ql          , Qlf         , Ql          , Ur          , Ur          ,           Xu,           Xu,           Xu,           Xu,           Xu,           Xu,           Xu,           Xu,           Xu,           Xu,           Xu,           Xu,           Xu,           Xu,           Xu,           Xu,           Xu,           Xu,           Xu,           Xu,           Xu,           Xu,           Xu,           Xu,           Xu,           Xu,           Xu,           Xu, Xu          , Xu          , Wo          , Ww^Bs/      , Ur^Vud      , Xu          ,           Xu,           Xu,           Xu,           Xu,           Xu,           Xu,           Xu,           Xu,           Xu,           Xu, Xu          , Xu          , Xu          , Xu          , Uu          , Uu          , Uu          , Xu          , Uu          , Xuc         , Uu^Vu       
Wo^Ii       , Xuc         ,           Xu,           Xu,           Xu,           Xu, Xu          , Xu          , Ql^Bs\      , Ql^Xo       , Cud         , Ql          , Uu          , Ql^Bs/      , Ur          ,           Xu,           Xu,           Xu,           Xu,           Xu,           Xu,           Xu,           Xu,           Xu,           Xu,           Xu,           Xu,           Xu,           Xu,           Xu,           Xu,           Xu,           Xu,           Xu,           Xu,           Xu,           Xu,           Xu,           Xu,           Xu,           Xu,           Xu,           Xu, Xu          , Cud         , Ur          , Xu          , Ur          , Cud         ,           Xu,           Xu,           Xu,           Xu,           Xu,           Xu,           Xu,           Xu,           Xu,           Xu, Xu          , Ww          , Ww          , Ss          , Xu          , Xu          , Uu          , Uu          , Uu          , Xuc         , Uu          
Xu          , Xuc         , Xu          , Ur          , Xu          , Uu^Vud      , Xu          , Ww          , Ww          , Xu          , Xu          , Ql^Xo       , Ql^Xo       , Ql          , Ur          ,           Xu,           Xu,           Xu,           Xu,           Xu,           Xu,           Xu,           Xu,           Xu,           Xu,           Xu,           Xu,           Xu,           Xu,           Xu,           Xu,           Xu,           Xu,           Xu, Xu          , Xu          , Xu          ,           Xu,           Xu,           Xu,           Xu,           Xu,           Xu, Xu          , Xu          , Xu          , Wo          , Xu          , Xu          ,           Xu,           Xu,           Xu,           Xu,           Xu, Xu          , Xu          , Xu          , Xu          , Xu          , Xu          , Wo          , Ww          , Ss          , Ss          , Ss          , Xu          , Uu          , Uu          , Uu          , Xuc         
Xue         , Xue         , Qxu^Xo      , Uu          , Ur          , Ur          , Xu          , Xu          , Xu          , Ww^Ii       , Ww^Ii       , Ww^Ii       , Xu          , Ur^Vud      , Xu          ,           Xu,           Xu,           Xu,           Xu,           Xu,           Xu,           Xu,           Xu,           Xu,           Xu,           Xu,           Xu,           Xu,           Xu,           Xu,           Xu,           Xu,           Xu,           Xu, Xu          , Xu          , Wo          , Xu          , Xu          ,           Xu,           Xu,           Xu, Xu          , Xu          , Xu          , Wo          , Xu          , Xu          , Xu          ,           Xu,           Xu,           Xu,           Xu,           Xu, Xu          , Xu          , Wo          , Xu          , Xu          , Wo          , Wo          , Xu          , Wo          , Wo          , Wo          , Xu          , Xu          , Uu          , Uu          , Xuc         
Uue^Ii      , Uue         , Uue^Vud     , Xu          , Xue         , Xu          , Wo          , Xu          , Xu          , Xu          , Xu          , Wwf^Ii      , Xuc         , Xu          , Xu          ,           Xu,           Xu,           Xu,           Xu,           Xu,           Xu,           Xu,           Xu,           Xu,           Xu,           Xu,           Xu,           Xu,           Xu,           Xu,           Xu,           Xu,           Xu,           Xu, Xu          , Wo^Es       , Xu          , Wo          , Xu          , Xu          , Xu          , Xu          , Xu          , Xu          , Wo          , Wo          , Wo          , Xu          , Wo          , Xu          , Xu          , Xu          , Xu          , Xu          , Wo          , Wo          , Wo          , Wo          , Wo          , Wo          , Wo          , Wo          , Wo          , Wo          , Cud         , Xu          , Cud         , Uu          , Uu^Emf      , Xu          
Xue         , Uue         , Xue         , Xue         , Xu          , Wo          , Xu          , Xu          , Xu          , Xu          , Ww          , Wwf^Ii      , Cud         , Xuc         , Xuc         , Xu          , Xu          ,           Xu,           Xu,           Xu,           Xu,           Xu,           Xu,           Xu,           Xu,           Xu,           Xu,           Xu,           Xu,           Xu,           Xu,           Xu,           Xu, Xu          , Cud         , Xu          , Wo          , Wo          , Xu          , Xu          , Xu          , Xu          , Wo          , Wo          , Xu          , Xu          , Xu          , Wo          , Xu          , Wo          , Wo          , Xu          , Wo          , Wo          , Wo          , Wo          , Wo          , Wo          , Wo          , Wo          , Wo          , Wo          , Wo          , Xu          , Xu          , Kud         , Xu          , Ur          , Xu          , Xu          
Xue         , Uue         , Xue         , Xue         , Wo          , Xu          , Xu          , Xu          , Wwf         , Ww          , Cud         , Cud         , Xuc         , Hh^Ii       , Xu          , Xu          , Xue         ,           Xu, Xu          ,           Xu,           Xu,           Xu,           Xu,           Xu,           Xu,           Xu,           Xu,           Xu,           Xu,           Xu,           Xu,           Xu, Xu          , Xu          , Uue         , Xu          , Xu          , Wo          , Wo          , Xu          , Wo          , Wo          , Xu          , Xu          , Uue^Ii      , Uue^Ii      , Xu          , Ww^Es       , Xu          , Wo          , Wo          , Wo          , Wo          , Wo          , Wo          , Wo          , Wo^Ftp      , Wo          , Wo          , Wo          , Wo          , Wo          , Wo          , Wo          , Xu          , Cud         , Ur          , Ur          , Ur^Vud      , Xu          
Xue         , Uue         , Uue^Vu      , Uue^Ufi     , Xu          , Wo          , Xu          , Xu          , Xu          , Xuc         , Xuc         , Xuc         , Xu          , Xu          , Wo          , Xue         , Uue         , Xue         , Uue^Vud     , Xu          , Xu          ,           Xu,           Xu,           Xu,           Xu,           Xu, Xu          , Xu          , Xu          , Xu          , Xu          , Xu          , Uue^Emf     , Uue         , Ww          , Xu          , Wo          , Wo          , Wo          , Wo          , Xu          , Xu          , Xu          , Uue^Uf      , Ww          , Ww^Vm       , Wo          , Xu          , Wo          , Ww          , Xu          , Xu          , Xu          , Wo          , Xu          , Xu          , Xu          , Ww^Ftp      , Ww^Ftp      , Wwr         , Wwr         , Wo          , Wo          , Wo          , Xu          , Cud         , Ur          , Ur          , Xu          , Xu          
Xu          , Xu          , Wo          , Wo          , Wo          , Xu          , Wo          , Xu          , Xu          , Xu          , Xu          , Xu          , Wo          , Wo          , Wo          , Xu          , Xu          , Uue^Ufi     , Xu          , Xu          , Xu          , Xu          , Xu          , Xu          , Xu          , Xu          , Xu          , Xu          , Wo          , Wo^Es       , Wo          , Uue^Ii      , Xu          , Ww^Vm       , Wo          , Wo          , Wo          , Wo          , Xu          , Xu          , Xu          , 3 Ww^Kov    , Wo^Cov      , Xu          , Wo          , Wo          , Wo          , Wo          , Wo          , Wo          , Xu          , Xu          , Wo          , Wo          , Xu          , Xu          , Xu          , Ww^Es       , Ww          , Wwr         , Ww          , Wwr         , Chw         , Chw         , Xu          , Xu          , Xu          , Xu          , Xu          , Xu          
Md          , Md          , Md          , Wo          , Wo          , Wo          , Wo          , Wo          , Wo          , Wo          , Wo          , Wo          , Wo          , Wo          , Wo          , Hhd^Vhcr    , Uu          , Md          , Wo          , Wo          , Wo          , Wo          , Wo          , Wo          , Wo          , Wo          , Wo          , Wo          , Wo          , Wo          , Wo          , Wo          , Wo          , Wo          , Wo          , Wo          , Wo          , Wo          , Mm          , Mm          , Mm          , Wo^Cov      , Wo          , Wo          , Wo          , Wo          , Wo          , Wo          , Ww^Vm       , Wo          , Wo          , Wo          , Wo          , Wo          , Mm          , Mm          , Mm          , Ww^Ewf      , Ww^Es       , Ww          , Ww          , Ww          , Chw         , 1 Khw       , Chr         , Mm^Xm       , Mm^Xm       , Mm          , Mm          , Mm          
Md          , Md          , Md          , Md          , Md          , Md          , Md          , Md          , Md          , Wo          , Wo          , Wo          , Md          , Wo          , Xu          , Xu          , Uu          , Xu          , Wo          , Wo          , Wo          , Wo          , Wo          , Wo          , Wo          , Wo          , Mm          , Wo          , Wo          , Wo          , Wo          , Wo          , Wo          , Wo          , Mm          , Wo          , Wo          , Wo          , Mm          , Mm          , Mm          , Wo          , Mm          , Wo          , Wo          , Wo          , Mm          , Mm          , Mm          , Mm          , Mm          , Wo          , Wo          , Wo          , Wo          , Mm          , Mm          , Mm          , Mm          , Ww^Es       , Wwr^Es      , Wwr^Es      , Wwr^Es      , Wwf         , Hhd^Es      , Mm^Xm       , Mm          , Mm          , Mm          , Mm          
Wo          , Md          , Md          , Md          , Md          , Md          , Md          , Hhd^Vd      , Md          , Wo          , Wo          , Md          , Hhd^Vd      , Md          , Xu          , Uu          , Xu          , Xu          , Wo          , Wo          , Xu          , Xu          , Xu          , Wo          , Wo          , Ww^Vm       , Mm          , Mm          , Wo          , Wo          , Wo          , Wo          , Mm          , Mm          , Mm          , Mm          , Wo          , Wo          , Wo          , Mm          , Wo          , Wo          , Ww^Vm       , Mm          , Wo          , Wo          , Mm          , Mm          , Mm          , Mm          , Mm          , Mm          , Wo          , Wo          , Wo          , Wo          , Mm          , Mm          , Mm          , Ww^Es       , Ww^Es       , Wwr^Es      , Ww^Vm       , Wwf         , Mm          , Mm^Xm       , Mm^Xm       , Mm          , Mm          , Mm          
Wo          , Wo          , Wo          , Md          , Md          , Md          , Md          , Md          , Wo          , Wo          , Wo          , Md          , Md          , Md          , Xu          , Xu          , Wo          , Wo          , Wo          , Wo^Es       , Xu          , Ur^Vud      , Ur          , Xu          , Wo          , Mm          , Mm          , Mm          , Wo          , Wo          , Wo          , Mm          , Mm          , Mm          , Mm          , Mm          , Wo          , Wo          , Mm          , Wo          , Wo          , Wo          , Mm          , Mm          , Wo          , Wo          , Wo          , Mm          , Mm          , Mm          , Hh          , Hh          , Wo          , Wo          , Wo          , Wo          , Wo          , Mm          , Mm          , Mm          , Mm          , Ww^Ewf      , Wwf         , Wwf         , Mm          , Mm          , Mm          , Mm^Xm       , Mm          , Mm          
Wo          , Wo          , Wo          , Wo          , Wo          , Md          , Wo          , Wo          , Wo          , Wo          , Wo          , Wo          , Wo          , Md          , Wo          , Wo          , Mm          , Wo^Es       , Xu          , Xu          , Ur          , Ur          , Cud         , Xu          , Wo          , Mm          , Wo          , Mm          , Wo          , Wo          , Wo          , Mm          , Mm          , Mm          , Mm          , Wo          , Wo          , Mm          , Wo          , Wo          , Wo          , Wo          , Wo          , Mm          , Mm          , Wo          , Wo          , Wo          , Wo          , Ww^Es       , Wo          , Wo          , Wo          , Wo          , Mm          , Wo          , Wo          , Mm          , Mm          , Mm          , Mm          , Mm          , Mm          , Hhd         , Mm          , Mm          , Mm          , Mm^Xm       , Mm^Xm       , Mm          
Wo          , Wo          , Wo          , Wo          , Wo          , Wo          , Wo          , Wo          , Wo          , Wo          , Wo          , Wo          , Wo          , Wo          , Md          , Md          , Md          , Xu          , Cud         , Ur          , Ur          , Xu          , Xu          , Xu          , Wo          , Wo          , Wo          , Wo          , Wo          , Wo          , Mm          , Hh          , Hh          , Mm          , Hh          , Wo          , Wo          , Mm          , Wo          , Wo          , Wo          , Wo          , Wo          , Wo          , Wo          , Wo          , Mm          , Wo          , Wo          , Wo          , Wo          , Wo          , Wo          , Wo          , Hh^Efm      , Ww^Vhhr     , Wo          , Wo          , Wo          , Mm          , Mm          , Mm^Xm       , Mm          , Ms^Vhha     , Mm          , Mm          , Mm          , Mm          , Wo^Dr       , Wwf^Bw/r    
Wo          , Wo          , Wo          , Wo          , Wo          , Wo          , Wo          , Wo          , Wo          , Wo          , Wo          , Wo          , Wo          , Wo          , Md          , Md          , Md          , Xu          , Xu          , Xu          , Xu          , Cud         , Xu          , Wo          , Mm          , Wo          , Mm          , Wo          , Wo          , Wo          , Mm          , Mm          , Hh          , Hh          , Wo          , Wo          , Wo          , Wo          , Xu          , Xu          , Xu          , Wo          , Wo          , Wo          , Wo          , Mm          , Mm          , Xu          , Xu          , Wo          , Wo          , Wo          , Hh          , Ww          , Ww          , Wo          , Wo          , Wo          , Wo          , Wo          , Mm          , Mm          , Mm          , Mm          , Hhd^Es      , Wwf^Bw\r    , Wwf^Bw\r    , Wo^Bw/r     , Wo          , Wo          
Mm          , Mm          , Mm          , Wo          , Ww^Vm       , Mm          , Mm          , Mm          , Mm          , Wo          , Wo          , Wo          , Wo          , Wo          , Wo          , Md          , Wo          , Xu          , Wo          , Wwf^Es      , Xu          , Uu          , Ww          , Ww          , Mm          , Mm          , Mm          , Mm          , Ww          , Ww          , Ww          , Hh^Vd       , Ww          , Wo          , Wo          , Wo          , Wo          , Hh          , Xu          , Qxua^Bs/    , Urb         , Xu          , Mm          , Wo          , Ww^Es       , Mm          , Mm          , Xu          , Xu          , Xu          , Xu          , Xu          , Xu          , Hh          , Wo          , Wo          , Wo          , Wo          , Wo          , Wo          , Mm          , Mm          , Mm          , Mm^Xm       , Wo^Es       , Wwf^Es      , Wo          , Wo          , Wo          , Wo          
Hd^Ft       , Mm          , Mm          , Mm          , Mm          , Mm          , Mm          , Mm          , Rr^Vd       , Mm          , Mm          , Wo          , Wo          , Wo          , Wo          , Wo          , Md          , Wo          , Md          , Md          , Md          , Mm          , Ww^Vhhr     , Ww          , Ww          , Mm          , Mm          , Mm          , Ww          , Ww          , Ww          , Ww          , Ww          , Wo          , Wo          , Wo          , Hh          , Xu          , Uu          , Qxua^Bs/    , Urb         , Urb         , Ww^Vm       , Mm          , Wo          , Wo          , Ww^Es       , Xu          , Xu          , Uue         , Uue         , Uue^Dr      , Xu          , Hh          , Wo          , Wo          , Mm          , Mm          , Wo          , Wo          , Mm          , Mm          , Mm          , Wo^Es       , Wo          , Wo          , Wo          , Wo          , Wo          , Wo          
Hd^Ft       , Hd^Ft       , Mm          , Mm          , Ds^Ft       , Dd^Es       , Mm          , Mm          , Mm          , Mm          , Mm          , Wo          , Wo          , Wo          , Md          , Md          , Wo          , Wo          , Md          , Md          , Md          , Hd          , Hhd         , Ww^Es       , Md          , Ww          , Ww          , Ww          , Ww^Es       , Mm          , Mm          , Ww          , Mm          , Ww          , Ww          , Hh^Vd       , Uh          , Uu^Ufi      , Uu          , Qxua^Bs/    , Urb         , Xu          , Wo          , Wo          , Mm^Cov      , Wo          , Mm          , Mm          , Mm^Vhhr     , Xu          , Xu          , Uue         , Uue^Vu      , Wo          , Wo          , Wo          , Mm          , Ww^Vm       , Wo          , Wo          , Wo          , Mm          , Mm          , Wo          , Wo          , Wo          , Wo          , Wo          , Wo          , Wo          
Hd^Ft       , Hd^Ft       , Hd^Ftp      , Hd^Ftp      , Ds^Ftd      , Mm          , Dd^Do       , Mm          , Mm          , Mm          , Mm          , Wo          , Wo          , Md          , Mm          , Mm          , Wo          , Wo          , Wo          , Md          , Md          , Md          , Md          , Md          , Md          , Md          , Mm          , Ww^Es       , Mm          , Mm          , Hh^Efm      , Hh^Efm      , Wo          , Mm          , Ww          , Mm          , Xu          , Xu          , Xu          , Xu          , Xu          , Xu          , Wo          , Hh          , 2 Mm^Kov    , Ww          , Mm          , Mm          , Mm          , Mm          , Xu          , Xu          , Wo          , Wo          , Wo          , Mm          , Wo          , Wo          , Wo          , Wo          , Wo          , Wo          , Wo          , Wo          , Wo          , Mm          , Wo          , Wo          , Mm          , Mm          
Dd^Vdt      , Mm          , Mm          , Mm          , Wot^Ewf     , Hd^Ftd      , Ds          , Ds          , Ds          , Mm          , Mm          , Wo          , Wo          , Wo          , Wo          , Wo          , Wo          , Wo          , Wo          , Wo          , Wo          , Md          , Md          , Md          , Md          , Md          , Wo          , Mm          , Wo          , Ww^Vm       , Wo          , Wo          , Wo          , Wo          , Wo          , Wo          , Wo          , Wo          , Wo          , Mm          , Wo          , Wo          , Wo          , Mm^Cov      , Wo          , Wo          , Wo          , Mm          , Wo          , Mm          , Wo          , Wo          , Wo          , Wo          , Wo          , Wo          , Wo          , Wo          , Wo          , Wo          , Wo          , Wo          , Wo          , Wo          , Wo          , Wo          , Wo          , Wo          , Wo          , Wwf         
Ds          , Hd^Ftd      , Mm          , Wot         , Wot         , Wwt         , Wwt         , Wwt         , Ds^Ecf      , Dd^Vdt      , Mm          , Mm          , Wo          , Wo          , Wo          , Wo          , Wo          , Wo          , Wo          , Wo          , Wo          , Wo          , Wo          , Wo          , Wo          , Wo          , Wo          , Wo          , Wo          , Wo          , Wo          , Wo          , Mm          , Mm          , Mm          , Wo          , Wo          , Wo          , Wo          , Wo          , Wo          , Wo          , Mm          , Wo          , Wo          , Wo          , Wo          , Wo          , Wo          , Wo          , Wo          , Wo          , Ww          , Ww          , Ww          , Wo          , Wo          , Wo          , Wo          , Mm          , Wo          , Wo          , Wo          , Wo          , Wo          , Wo          , Wo          , Wo          , Wo          , Wo          
Wwt         , Wwt         , Wot         , Wot         , Wot         , Wot         , Wot         , Wwt         , Mm          , Ds          , Mm          , Mm          , Wo          , Wo          , Wo          , Wo          , Md          , Wo          , Wo          , Wo          , Wo          , Wo          , Wo          , Wo          , Wo          , Wo          , Wo          , Md          , Md          , Wo          , Wo          , Mm          , Mm          , Mm          , Mm          , Mm          , Wo          , Wo          , Wo          , Wo          , Mm          , Mm          , Mm          , Wo          , Wo          , Ww^Vd       , Wo          , Wo          , Wo          , Wo          , Mm          , Ww          , Hh          , Ww^Vm       , Mm          , Mm          , Wo          , Wo          , Wo          , Wo          , Wo          , Wo          , Mm          , Mm          , Mm          , Wo          , Wo          , Wo          , Wo          , Wo          
Wot         , Wot         , Wo          , Wo          , Mm          , Wo          , Wo          , Wot         , Wot         , Mm          , Mm          , Wo          , Wo          , Wo          , Wo          , Hhd^Vhcr    , Dd^Es       , Md          , Md          , Mm          , Wo          , Wo          , Wo          , Wo          , Wo          , Wo          , Wo          , Md          , Md          , Mm          , Wot         , Mm          , Mm          , Mm^Xm       , Mm          , Mm          , Wo          , Wo          , Wo          , Wo          , Wo          , Wo          , Wo          , Wo          , Wo          , Wo          , Wo          , Wo          , Mm          , Mm          , Mm          , Mm          , Mm          , Mm          , Mm          , Mm          , Wo          , Wo          , Wo          , Wo          , Wo          , Mm          , Mm^Xm       , Mm^Xm       , Mm          , Wo          , Wo          , Wo          , Wo          , Wo          
Wo          , Wo          , Mm          , Mm          , Wwg         , Mm          , Wo          , Wo          , Mm          , Mm          , Wo          , Wo          , Wo          , Wo          , Wo          , Ww^Es       , Wwr         , Ww^Es       , Md          , Mm          , Mm          , Wo          , Wwf^Es      , Ww^Vm       , Mm          , Wo          , Wot         , Wot         , Wot         , Wot         , Wot         , Wot         , Mm          , Mm          , Mm          , Wo          , Wo          , Wo          , Wo          , Wo          , Wo          , Wo          , Wo          , Wo          , Wo          , Wo          , Mm          , Mm          , Mm          , Mm          , Wwr         , Wwr         , Wo          , Wwr         , Wo          , Wo          , Wo          , Wo          , Wo          , Wo          , Wo          , Mm          , Mm          , Mm          , Wo          , Wo          , Wo          , Wo          , Wo          , Wo          
Wo          , Wo          , Mm          , Wwg         , Wwg         , Mm          , Wo          , Wo          , Wo          , Wo          , Wo          , Wo          , Wo          , Wo          , Wo          , Wo          , Wo          , Wwr         , Wo          , Md          , Wwr         , Mm          , Mm          , Mm          , Mm          , Mm          , Wot         , Wot         , Wot         , Wot         , Wot         , Wot         , Wot         , Mm          , Wo          , Wo          , Wo          , Wo          , Mm          , Mm          , Mm          , Wo          , Wo          , Wo          , Wo          , Wo          , Wo          , Mm          , Wwr         , Wwr         , Wo          , Wo          , Wo          , Wo          , Wo          , Wo          , Wo          , Wo          , Wo          , Wo          , Wo          , Wo          , Wo          , Wo          , Wo          , Wo          , Wo          , Wo          , Wo          , Wo          
Wo          , Mm          , Mm          , Wwg         , Mm          , Mm          , Wo          , Wo          , Wo          , Wo          , Wo          , Wo          , Wo          , Wo          , Wo          , Wo          , Wo          , Wo          , Wo          , Wo          , Wo          , Wwr         , Wo          , Wwr         , Wo          , Wo          , Wo          , Wot         , Wot         , Wot         , Wot         , Wot         , Wot         , Wot         , Wot         , Md          , Md          , Wwrt        , Wo          , Ww^Es       , Wot         , Wo          , Wot         , Wot         , Wot         , Wo          , Wot         , Wo          , Wo          , Wo          , Wo          , Wo          , Wo          , Wo          , Wo          , Wo          , Wo          , Wo          , Wo          , Wo          , Wo          , Wo          , Wo          , Wo          , Wo          , Wo          , Wo          , Wo          , Wo          , Wo          
